오늘 야외 수업하자고 조르자	오늘 야외 수업하자고 조르기	1
소이 방 컴퓨터 화면 보여주렴	소이 방 컴퓨터 화면	1
이 라디오 방송을 녹음해	이 라디오 방송 녹음하기	1
버스 정류소에 차를 세우면 안돼	버스 정류소에 차 세우기	0
명동 도로 상황을 보여주렴	명동 도로 상황	1
저 이번 주에 댁으로 찾아뵙겠습니다 화 푸세요	화 풀기	1
졸업 여행 참가자는 회비를 내일까지 완납 바람	졸업 여행 참가자는 회비 내일까지 완납하기	1
정명석 목사의 해외도피 관련기사를 보여라	정명석 목사 해외도피 관련기사	1
티비 꺼	티비 끄기	1
결석한 학생은 사유서를 제출하세요	결석한 학생은 사유서 제출하기	1
부산 소재 해수욕장의 기온분포를 알려	부산 소재 해수욕장 기온분포	1
유의사항을 반드시 읽어보세요	유의사항 읽기	1
자원봉사도 약속이에요 연락 없이 빠지지 마세요	자원봉사 연락 없이 빠지기	0
로봇 이제 가서 쉬어라	가서 쉬기	1
우리 기술을 유포되지 않도록 조심해	우리 기술 유포되지 않도록 조심하기	1
안방 선풍기 취침모드로	안방 선풍기 취침모드로 하기	1
초희방에 가서 십오분 뒤에 알람 세 번 울려 주겠니	초희방에 가서 십오분 뒤 알람 세번 울리기	1
오늘 추운데 그냥 등산 취소하자	오늘 등산하기	0
인쇄해서 제출 해 줄 수 있어	인쇄해서 제출하기	1
과식을 하지 마세요 	과식하기	0
티비 채널을 십 삼 번으로 돌려줄래	티비 채널 십 삼 번으로 돌리기	1
뭐하고 지내냐 학원 다시 나와 선생님이 걱정하시잖아	학원 다시 나오기	1
왜 꼭 그런 장래성 없는 회사 주식만 골라서 사 	장래성 없는 회사 주식 사기	0
백화점 세일해 쇼핑 가자	백화점 쇼핑가기	1
이메일 차례대로 열어라	이메일 차례대로 열기	1
대리 이것 원리합계 좀 내 주게나	원리합계 내주기	1
차선 변경 할 때는 표시등을 키고 진입 해야지	차선 변경할 때는 표시등 키고 진입하기	1
진짜 많이 올랐다 너 빨리 팔아	빨리 팔기	1
박찬호 선수 기사 좀 찾아주련	박찬호 선수 기사	1
약속 지켜야 돼	약속 지키기	1
삼겹살 먹고 이차로 맥주 어때 	삼겹살 먹고 이차로 맥주 먹기	1
고속버스에서 창문 열면 조금 위험하다고	고속버스에서 창문 열기	0
시끄럽다 조용히 해	조용히 하기	1
웨딩 촬영할 때 네가 나 도와줘	웨딩 촬영할 때 도와주기	1
밥이 보약이야 꼭 챙겨먹어	밥 챙겨먹기	1
부실 채권을 보유하고 있는 금융계에는 투자가 신중해야 해	부실 채권을 보유하고 있는 금융계에 투자 신중하기	1
내부 순환도로에 교통 사고 난 지점은 어딘지 알려	내부순환도로 교통사고 지점	1
빌려준 돈 다음주까지 꼭 갚아라	빌려준 돈 다음주까지 갚기	1
가스레인지에 불 꺼라	가스레인지 불 끄기	1
전화 많이 하면 안좋다	전화 많이 하기	0
어려운 일이 있으면 도움을 요청해	어려운 일 있으면 도움 요청하기	1
김초롱 어제 경기 관련 기사 찾아주렴	김초롱 어제 경기 관련 기사 찾기	1
빠지지마	빠지기	0
이번에 광주에서 국제 모터쇼가 열리는데 같이 가지 않을래	광주 국제모터쇼 같이 가기	1
너무 얇게 보지 말고 깊게 좀 봐라	깊게 보기	2
이번 주부터 집 근처에 있는 교회 꼭 나가	이번 주부터 집 근처 교회 나가기	1
서울로 무궁화호도 두 장 예약해	서울로 무궁화호 두 장 예약하기	1
교통 흐름이 나아졌는지 파악해주련	교통 흐름이 나아졌는지	1
음식물 쓰레기는 별도의 용기에 담아서 버려주세요	음식물 쓰레기는 별도의 용기에 담아서 버리기	1
갑자기 목돈이 필요할 때는 대비해서 저축은 필수야	저축하기	1
작년 전국 주요 도시 기후표를 보여라	작년 전국 주요 도시 기후표	1
미술관에서는 사진 촬영을 금합니다	미술관에서 사진 촬영하기	0
너무 졸려서 그러니 한시간 뒤에 나 좀 깨워줄래 	한시간 뒤에 깨워주기	1
너무 추우니 귀마개라도 하고 와	귀마개하고 오기	1
삐지지마	삐지기	0
창 쪽 자리로 부탁해요	창 쪽 자리 주기	1
균형 잡힌 몸을 원하시면 스쿼시는 어떨까요 	스쿼시하기	1
너 차에 헤드라이트 켜져 있던데 빨리 나와서 꺼	헤드라이트 빨리 나와서 끄기	1
햇빛도 무지 강해진데 나 양산 사주라	양산 사주기	1
홋카이도가면 우리 꼭 라면 먹어보자	홋카이도가면 라면먹어보기	1
부동산 관련 기사를 모두 찾아라	부동산 관련 기사	1
스키 타러 가자	스키 타러 가기	1
여덟시에 저절로 켜지게 설정해주겠니	여덟시에 저절로 켜지게 설정하기	1
일회용품을 사용하지 맙시다	일회용품 사용하기	0
항공 우편이요	항공 우편 보내기	1
애기 보느라 힘드셨을텐데 들어가서 쉬세요	들어가서 쉬기	1
퇴근길에 슈퍼에 들르자	퇴근길에 슈퍼에 들르기	1
책상 위에 네가 말한 서류 올려놨어 가져가	책상 위에 서류 가져가기	1
여행 적금 들어서 해외 여행 갈까 	여행 적금 들어 해외여행 가기	1
서울 부산 비행기 왕복표 중학생 한 사람 예약해	서울 부산 비행기 왕복표 중학생 한 사람 예약하기	1
아무도 없는 방 전기는 다 내려주겠니	아무도 없는 방 전기 다 내리기	1
어제 기상 특보가 발효된 지역을 찾아라	어제 기상 특보 발효 지역	1
더워도 배는 꼭 덮고 자	배 덮고 자기	1
컴퓨터 좀 꺼	컴퓨터 끄기	1
다음 주 반상회까지는 모두 참여해주시기 바랍니다	다음 주 반상회까지는 참여하기	1
건물 뒷골목으로 들어와서 직진하세요	건물 뒷골목으로 들어와서 직진하기	1
대문 앞 카메라로 찍어	대문 앞 카메라로 찍기	1
베컴 관련 기사 찾아	베텀 관련 기사 찾기	1
샤라포바와 관련된 테니스 경기 기사 찾아	샤라포바 관련 테니스 경기 기사	1
수유리로 가려면 지하철 사호선을 타고 가세요	수유리로 가려면 지하철 사호선 타고 가기	1
우리 둘 만의 약속이니까 비밀이야	비밀 지키기	1
이제 그만 만나	만나기	0
오늘 서울행 고속철 일 인 예매해	오늘 서울행 고속철 일 인 예매하기	1
환승 버스에선 꼭 카드를 찍고 내려라	환승 버스에서 카드 찍고 내리기	1
회원 전부 다 참석해야 합니다 한 명도 빠지면 안됩니다	회의 전부 다 참석하기	2
우리 새벽에 동대문 쇼핑하러 가자	새벽에 동대문 쇼핑 가기	1
걔도 규칙적으로 운동하더니 제법 날씬해졌더라 너도 해	규칙적으로 운동하기	1
오늘 내 생일파티 세 시에 할 거야 꼭 와 	오늘 세 시 생일파티 오기	1
오늘 많이 더운데 더위 조심해	오늘 더위 조심하기	1
서두르지마	서두르기	0
포토샵으로 수정해 주세요	포토샵으로 수정하기	1
주거래 은행을 하나 정해 놓는 것이 유리할 거야	주거래 은행을 하나 정해 놓기	1
그러지마	그러기	0
일주일 뒤에 다시 진료 받으러 오세요	일주일 뒤에 다시 진료받으러 오기	1
애기가 어디에 있는지 찾아서 보고 와	애기 있는 위치	1
한국일보 사설만 보여라	한국일보 사설	1
우리나라 공항 예보를 보여	우리나라 공항 예보	1
오토바이는 위험하니까 버스를 타고 다니는 게 어때 	버스 타고 다니기	1
산에 올라 갈 때는 물을 꼭 들고 가야해 준비해 와라	물 준비해 오기	1
주가 상승과 은행금리에 관한 보고서를 제출하세요	주가 상승과 은행금리에 관한 보고서 제출하기	1
대출 성공했음 이따가 저녁 쏴	이따가 저녁 쏘기	1
트윈으로 예약하고 싶어요	트윈으로 예약하기	1
부시의 북한 인권법안 서명 관련 기사 찾아라	부시 북한 인권법안 서명 관련 기사	1
와이티엔 뉴스 채널의 주요 뉴스를 보자	와이티엔 뉴스 채널 주요 뉴스	1
저녁 같이 합시다	저녁 같이 하기	1
한 시간 동안 움직이지 마	한시간 동안 안 움직이기	1
세탁기 불림 코스 선택	세탁기 불림 코스 선택하기	1
강당에서 예금상품관련 특강 있으니까 들어	강당에서 예금상품관련 특강 듣기	1
아이로비 현관으로 가	현관으로 가기	1
최강의 스페셜포스의 대원에 합류하라	스페셜포스 대원에 합류하기	1
이 기계에는 꼭 정품의 부품만을 사용해주십시오	정품 부품 사용하기	1
졸업 전시회는 이번 주 까지입니다 꼭 오세요	졸업 전시회 오기	1
빚내서 하는 거 아니야	빚내서 하기	0
우리 연락 좀 하고 살자	연락하고 살기	1
계단을 오를 때는 좌측통행을 합시다	계단을 오를 때 좌측통행 하기	1
우리 그룹과외하자 비용도 싸고 서로 경쟁도 될 것 같아	그룹과외하기	1
이메일이 도착하면 알려줄래	이메일이 도착하면 알려주기	1
나중에 얘기해	나중에 얘기하기	1
가을도 됐으니 단풍 구경도 할 겸 등산이 어떨까 	등산하기	1
오빠 피곤하겠다 얼른 자	얼른 자기	1
텔레비전 소리 모노로 전환해줄래	텔레비전 소리 모노로 전환하기	1
탈북 축구인 대회에 관한 기사를 찾아줄래	탈북 축구인 대회	1
국민과의 약속을 지키시오	국민과의 약속 지키기	1
공부하기 싫으면 학교 그만 둬	학교 그만두기	1
주식하려면 모의투자로 시작하고 공부 많이 해야 돼	모의투자로 시작하고 공부 많이 하기	1
일단 사업계획서부터 작성해 오라고	사업계획서 작성하기	1
간만에 시골길 드라이브 어때 	시골길 드라이브하기	1
그 제품의 제조와 유통을 피해 주시기 바랍니다	그 제품 제조하고 유통하기	0
김윤희씨 현대정신병원에서 입원부탁합니다	현대정신병원에서 입원하기	1
휩쓸리지 않고 스스로를 객관적으로 바라보는 것이 중요다고 본다	스스로를 객관적으로 바라보기	2
횡보하는 구간에서 매수 타이밍을 잡는다	횡보하는 구간에서 매수 타이밍 잡기	1
앞으로 두 시간 뒤에 모두 취침에 들어가십시오	아픙로 두 시간 뒤에 취침에 들어가기	1
비자 신청해	비자 신청하기	1
할머님이 위독하시다 빨리 와	빨리 오기	1
그냥 화장품이나 하나 사죠	화장품 하나 사기	1
기다린다 천천히 와	천천히 오기	1
사업에 따른 제반 여건을 조사해 봅시다	사업에 따른 제반 여건 조사하기	1
이십일 열두시 잠실대교의 흐름을 보여라	이십일 열두시 잠실대교 흐름	1
바람에 간판이 날릴지도 모르니 주의해	바람에 날리는 간판 주의하기	1
회사에 주차 공간 좀 확충해 주십시오	회사에 주차 공간 확충하기	1
잘 알아보고 이용해	잘 알아보고 이용하기	1
아니 안바뻐 술 한잔 할까	술 한잔 하기	1
기다리지마	기다리기	0
무산소운동과 유산소운동을 병행하는 것이 좋습니다	무산소운동과 유산소운동 병행하기	1
보기 싫어	보여주기	0
부장님 피곤하실텐데 오전엔 쉬세요	오전에 쉬기	1
초희방 침대 보여주겠니	초희방 침대	1
외국인이 팔아버린 주식은 웬만하면 사지 마	외국인이 팔아버린 주식 사기	0
더운데 은행에서 좀 기다려	은행에서 기다리기	1
허브가 왜 우리 몸에 좋은 건지 알고 싶습니다	허브가 우리 몸에 좋은 이유	1
월급 탔으니 한턱 쏘마 나와	나오기	1
우리도 접대 형식을 좀 바꿔 보죠	접대 형식 바꾸기	1
기간에 맞춰 신청바랍니다	기간에 맞춰 신청하기	1
헬스 끊어놓고 일주일째 안 나올 거면 집에서 먹을 것 사와서 놀지 않을래 	집에서 먹을 것 사와서 놀기	1
가장 최근에 열린 농구 경기 관련 기사를 찾아라	가장 최근 열린 농구 경기 관련 기사	1
열시 이십분 미국가는 비행기를 예약해	열시 이십분 미국가는 비행기 예약하기	1
김철수도 같이 예약하렴	김철수도 같이 예약하기	1
나 길을 몰라서 좀 같이 가줄수 있으신가	같이 가주기	1
자기가 못 푼 문제는 한 번 더 풀어봐라	자기가 못 푼 문제 한번 더 풀기	1
요즘 이율도 별론데 무슨 적금이야	적금 들기	0
나하고 내일부터 운동장 다섯 바퀴만 돌자	나하고 내일부터 운동장 다섯 바퀴 돌기	1
방금 택배 보냈으니까 내일 쯤 갈 거야 받으면 연락해	택배 받으면 연락하기	1
그 선생님 시험문제는 교재보다는 기타내용 위주로 나오니까 노트 보는 게 낫겠지	보트 보기	1
술 한잔 사줄꺼지	술 한잔 사주기	1
건형씨도 도시락 싸온 거면 열두 시에 사백십사 호에서 봐요	열두 시에 사백십사 호에서 보기	1
파도가 높으니까 해수욕장은 포기해	해수욕장 가기	0
요즘 요가가 유행이라는데 같이 배울까 	요가 같이 배우기	1
뭐야 투표도 안하고 놀러 가 투표하고 같이 놀러 가자	투표하고 놀러가기	1
연합회 모임에 차질 없으시기 바라며 꼭 참석하기 바랍니다	연합회 모임 꼭 참석하기	1
해외법인 실적 호전주를 주목해 봐	해외법인 실적 호전주 주목하기	1
난 건강 빼면 시체야 걱정 말고 네 몸이나 챙겨	몸 챙기기	1
조깅하실 때 아침보다는 저녁에 뛰세요	조깅할 때 아침보다는 저녁에 뛰기	1
모레 오후에 여행사에 다시 전화해	모레 오후 여행사에 다시 전화하기	1
제품의 질을 향상하는 방향으로 기획해 봅시다	제품의 질을 향상하는 방향으로 기획하기	1
이번 달은 비가 많이 와서 홍수피해 예방해야 해	홍수피해 예방하기	1
쇼핑하러 코엑스 가기로 한 거 안 잊었지	코엑스 가기	1
반신욕 한번에 오래 하지 마	반신욕 한번에 오래 하기	0
정암배 주니어에 관한 기사를 찾아줄래	정암배 주니어 관한 기사	1
감기가 유행이야 비타민 챙겨먹고 건강관리 잘해	비타민 챙겨먹고 건강관리 잘하기	1
대리 이번에 승진한다며 한턱 쏴	한턱 쏘기	1
사당 역 육 번 출구로 나와서 걷고 있어	사당역 육번출구로 나와서 걷기	1
어젯밤 온 메일 중 첨부 파일이 든 메일은 얼마나 되는지 확인해	어젯밤 온 메일 중 첨부 파일이 든 메일 수	1
동휘에게 연락 왔는데 외로우니까 편지 좀 많이 하래	동휘한테 편지 많이 하기	1
기획 서에 따른 세부사항을 짜보도록 하게	기획 서에 따른 세부사항 짜기	1
이번 금요일 밤에 술이나 한 잔 하자	이번 금요일 밤 술 한잔 하기	1
안전 벨트 메라	안전벨트 메기	1
바쁘시지 않은 날 연락 주시면 그때 봐요	바쁘지 않은 날 연락 주기	1
쇼핑하기 좋은 데 알아 놨어 같이 가자	쇼핑 같이 가기	1
약속 장소는 기억하기 쉬운 곳이 좋아요	약속 장소 기억하기 쉬운 곳으로 하기	1
친한 친구와 공책을 바꾸어 봐	친한 친구와 공책 바꾸어 보기	1
차도에 날치기를 주의 하십시오	차도에 날치기 주의하기	1
세탁기 켜라	세탁기 켜기	1
밥통에 취사 버튼으로 해	밥통 취사 버튼으로 하기	1
침대 옆에서 공부하지마 자꾸 눕고 싶어	침대 옆에서 공부하기	0
어렵게 생각하지 말고 단순하게 생각해	단순하게 생각하기	2
야 밖에 나올 생각하지 마라	밖에 나오기	0
너 이번에는 약속 시간에 꼭 맞춰서 나와야 돼	약속 시간 맞춰 나오기	1
열 시에 여기서 기다려주실 거죠	열 시에 여기서 기다리기	1
칼슘 영양제를 한 번 섭취해 보세요	칼슘 영양제 섭취하기	1
그러니까 너도 적당히 해	적당히 하기	1
오늘 밤 예상 기온을 알려주렴	오늘 밤 예상기온	1
현관 보여주렴	현관 보이기	1
공부 열심히 해	공부 열심히 하기	1
집에 도착하면 전화해	전화하기	1
축하해죠	축하하기	1
은행 옆에 큰 슈퍼 보이지 거기서 기다리고 있어	은행 옆에 큰 슈퍼에서 기다리기	1
이거 선생님한테 여쭤 보자	이거 선생님한테 여쭤 보기	1
십년 뒤 이 장소에서 다시 보자	십 년 뒤 이 장소에서 다시 보기	1
쭈욱 들어와	쭈욱 들어오기	1
피스컵 관한 기사를 찾아라	피스컵 관한 기사	1
비밀 번호 유출 되지 않게 조심해	비밀번호 유출 조심하기	1
화 내지마	화내기	0
이리로 와라	이리로 오기	1
너네 학교 도서관에서 같이 공부할까	학교 도서관에서 같이 공부하기	1
우리 오늘 쇼핑하러 밖에 나가 보자	오늘 쇼핑하러 밖에 나가기	1
베란다 밖에 누가 있는지 보고 와	베란다 밖에 누가 있는지 보고 오기	1
오늘 영하 오도니까 옷을 단단히 챙겨 입어 	오늘 옷 단단히 챙겨 입기	1
창쪽 좌석으로 예약할래	창쪽 좌석 예약하기	1
부음란을 보여주렴	부음란	1
상반기 부동산 정책 기사를 보여라	상반기 부동산 정책 기사	1
난방기 전원을 켜주렴	난방기 전원 켜기	1
라식 수술 후 컴퓨터 앞에 너무 오래 앉아 있지 마세요	컴퓨터 앞에 오래 앉아 있기	0
작은방에 청소기 밀어줄래	작은방에 청소기 밀기	1
커피 두 잔을 만들어주련	커피 두 잔 만들어주기	1
우리 크리스마스 때 나하고 보내줄 거지 	크리스마스 함께 보내기	1
왜 전화 안해	전화하기	1
부담 갖지 마시고 한번 구경 와	구경오기	2
걔 드디어 오늘이 발표 날이란다 같이 가서 응원이나 해 주자	오늘 발표 같이 가서 응원하기	1
학교로 직접 문의해서 과외선생님 구하는 건 어때 	학교로 직접 문의해서 과외선생님 구하기	1
오늘 저녁 정기 모임 잊으시면 안돼요	오늘 저녁 정기 모임 오기	1
내일은 추우니깐 꼭 껴입어	내일 꼭 껴입기	1
팔팔 올림픽 성과 관련 기사를 검색해	팔팔 올림픽 성과 관련 기사	1
깨지기 쉬우니 조심해서 다루어 주십시오	조심해서 다루기	1
오늘 서귀포 해상의 날씨를 보여라	오늘 서귀포 해상 날씨	1
산책로 내에 자전거나 애완견을 데리고 들어올 수 없습니다	산책로 내에 자전거나 애완견 데리고 들어오기	0
이 이메일을 심흔한테 보내라	이메일 심흔한테 보내기	1
하루에 사십분 이상씩 운동해야 돼	하루에 사십분 이상씩 운동하기	1
화 내지마	화내기	0
나 너무 추워서 백화점 안에 들어와 있어 와서 전화해	와서 전화하기	1
그놈의 목욕탕은 제정신 일 때 가야지	목욕탕 제정신일 때 가기	1
스타벅스 금연이라서 안되 커피빈으로 가자	커피빈으로 가기	2
너 바쁘다고 아침밥 거르지 말고 꼭 챙겨먹어라	아침밥 챙겨 먹기	2
다음 주까지 오십 퍼센트 완료합시다	다음 주까지 오십 퍼센트 완료하기	1
참여 인력과 유사 실적에 관한 평가 부탁해	참여 인력과 유사 실적 관한 평가하기	1
회신 이메일 모두 알려	회신 이메일 모두	1
유통망을 좀 더 넓히는데 힘쓰도록 합시다	유통망 넓히는 데 힘쓰기	1
오늘부터 업무시간 중에 인터넷 웹 서핑 삼가 하도록 합니다	업무시간 중 인터넷 웹 서핑하기	0
우리나라 날씨와 세계날씨에 대해서 알고 싶은데요	우리나라 날씨와 세계날씨	1
과외비 계좌 이체로 달라고 그래	과외비 계좌 이체로 달라고 하기	1
인라인 스케이트를 타고 운동장 한 바퀴 돌아보는 게 어때 	인라인 스케이트 타고 운동장 한바퀴 돌아보기	1
회전을 멈춰라	회전하기	0
워낙 약속개념이 없는 사람이니까 잘 챙겨	잘 챙기기	1
지금 오토바이 타고 바로 달려 와	지금 오토바이 타고 바로 달려오기	1
경기장 내 질서유지를 위해 주류반입을 금지합니다	경기장 내	0
최근에 독일축구 관련 기사가 있는지 찾아주렴	최근 독일축구 관련 기사	1
레드 데블스 관련 기사를 찾아	레드 데블스 관련 기사	1
음악 시디를 한 번 더 돌려주라	음악 시디 한 번 더 돌리기	1
작은방에 가 있어	작은방에 가 잇기	1
마감일까지 서류 제출해주시기 바랍니다	마감일까지 서류 제출하기	1
국도 이용해서 귀경하시는 것도 괜찮을 것 같은데요	국도 이용해서 귀경하기	1
자기야 나 한강 유람선 꼭 타보고 싶어 	한강 유람선 타기	1
금요 철야에 기도 모임 있으니 참석 요망	금요 철야 기도 모임 참석하기	1
세탁기 물 사십 오 도로 설정해 주겠니	세탁기 물 사십 오 도로 설정하기	1
스팸 이메일함 삭제해줄래	스팸 이메일함 삭제하기	1
도서관에서 자료 찾아봐 나도 거기서 찾았어	도서관에서 자료 찾아보기	1
무료 문화 강좌가 있으니 많은 참여 바랍니다	무료 문화 강좌 참여하기	1
동아일보 오늘 별자리별 운세를 보자	동아일보 오늘 별자리별 운세	1
대외 협력사항을 촉진시켜 주시기 바랍니다	대외 협력사항 촉진하기	1
경남엔 비 안 오니까 그냥 와	경남에 그냥 오기	1
공부에 대한 스트레스 하루쯤 시간 내서 기분 전환해봐	하루쯤 시간 내서 기분 전환하기	1
경력사항에 반드시 담당업무의 내용도 기재하세요	경력사항에 담당업무 내용 기재하기	1
오늘 오전에 온 새 편지 찾아	오늘 오전 새 편지	1
먼저 들어가 쉬어 내가 뒷정리 하고 갈게 	먼저 들어가 쉬기	1
랜덤하게 틀어주겠니	랜덤하게 틀기	1
여기서 대구까지 정체구간을 파악해서 알려	여기서 대구까지 정체구간	1
회식은 지난번 그 뷔페에서 하는 걸로 하죠	회식 지난번 그 뷔페에서 하기	1
하나투어에 패키지 상품 알아놔	하나투어 패키지 상품	1
해외에서 계약하러 오니까 공항으로 마중을 가게	공항으로 마중가기	1
내일 세시 강릉가는 고속버스 네 장 예매해	내일 세시 강릉가는 고속버스 네 장 예매하기	1
엘피지에이 대회의 경기 결과 관련 기사 찾아주렴	엘피지에이 대회 경기 결과	1
사 인실 취소해	사 인실 취소하기	1
오후 여섯시 이후에 온 이메일은 다 쓰레기통으로 보내라	오후 여섯시 이후에 온 이메일 다 쓰레기통으로 보내기	1
운전 중 휴대 전화 사용도 금지다	운전 중 휴대전화 사용하기	0
더위 좀 피하러 바닷가에나 같다 오자	바닷가에 같다 오기	1
독감 예방접종 꼭 해	독감 예방접종하기	1
아이들의 관점도 존중해줄 필요가 있어	아이들의 관점도 존중하기	1
통장 비밀 번호로 연락처 쓰면 안 되요	통장 비밀번호로 연락처 쓰기	0
인사동에서 전시회 할거야 꼭 와주길 바래	인사동 전시회 오기	1
환율 떨어진다고 엄마가 해외 송금 좀 천천히 하래	해외 송금 천천히 하기	1
시간 나면 너도 요가를 배워봐 피부가 좋아진다니까	요가 배우기	1
주말인데 놀러 가서 예쁜 사진 찍고 오자	놀러 가서 예쁜 사진 찍고 오기	1
한 시간 동안 동작 정지	한 시간 동안 동작 정지하기	1
욕심부리지 말고 조금이라도 올랐을 때 팔아	조금이라도 올랐을 때 팔기	2
지난주 전국 해상 날씨를 찾아라	지난주 전국 해상 날씨	1
예약은 바다가 보이는 방이다	바다가 보이는 방 예약하기	1
푹푹 찌는데 삼계탕 한 그릇으로 몸보신이나 할까 	삼계탕 먹기	1
공군기지 이전 관련 기사를 찾아라	공군기지 이전 관련 기사	1
지금 들어오는 전철이야 타	지금 들어오는 전철 타기	1
앞 좌석에 앉을 때는 꼭 안전벨트를 매야 된다	안전멜트 매기	1
통일교의 집단 결혼에 관련된 기사를 보여라	통일교 집단 결혼 관련 기사	1
오늘 운동장 스무 바퀴만 뛰고 가자	오늘 운동장 스무 바퀴 뛰고 가기	1
일정을 프린트해서 아버지 가져다 드려라	일정 프린트해서 아버지 가져다 드리기	1
내일부터 술도 줄이세요 약속해요	내일부터 술 줄이기	1
이재록 목사 강간 소식을 찾아라	이재록 목사 강간 소식	1
오픈하자마자 좋은 자리 맡자	오픈하자마자 좋은 자리 맡기	1
오디오 볼륨을 최대로 높여줄래	오디오 볼륨을 최대로 높이기	1
학과사무실 가서 결석계 받아 가	학과사무실 가서 결석계 받아가기	1
너무 일찍 약속 잡지 마 나 또 늦으면 뭐라 할 거잖아	너무 일찍 약속잡기	0
몸 피곤하게 만들지 말고 휴식을 취해	휴식 취하기	2
업무를 위임한 사람들과 자주 연락을 하세요	업무 위임한 사람들과 자주 연락하기	1
계좌 조회 좀 해봐 어제 돈 송금했어	계좌 조회하기	1
기차 안에서 돌아다니는 것은 위험해	기차 안에서 돌아가니기	0
보일러 온도를 올려줄래	보일러 온도 올리기	1
모든 모니터를 보여라	모든 모니터 보이기	1
컴퓨터 관련 책 좀 빌릴 수 있을까	컴퓨터 관련 책 빌리기	1
현관문 잠가	현관문 잠그기	1
약사가 그거 매일 먹어줘야 효과 있는 거라고 했잖아 	그거 매일 먹기	1
미국 국회의원 선거에 대한 기사를 찾아	미국 국회의원 선거 기사	1
일을 할 때 의사소통이 원활히 되지 않으면 안돼	의사소통 원활히 되기	1
서운한 일은 그때그때 이야기 하기로 해	서운한 일은 그때그때 이야기하기	1
미국의 국경일 날짜를 모두 검색해	미국 국경일 날짜 모두	1
사원 여러분의 많은 관심 부탁드립니다	많은 관심 가지기	1
동남아시아 시장 개척을 위해 노력합시다	동남아시아 시장 개척을 위해 노력하기	1
용산구의 정체구간 보여주렴	용산구 정체구간	1
그래봐	그러기	0
우리 먼저 만날게 너는 시간 맞쳐와	시간 맞쳐오기	1
방안에 있는 책들 전부 가져오래	방안에 있는 책들 전부 가져오기	1
부천 영화제 관련기사 찾아라	부천 영화제 관련기사	1
내 책상 위를 좀 찍어와	내 책상 위 찍기	1
먼저 투자할 기업에 대해서 정확히 아는 것이 중요해	투자할 기업에 대해서 정확히 알기	1
걸을 때 발은 뒤꿈치부터 땅에 닿도록 하고 걷습니다	걸을 때 발은 뒤꿈치부터 땅에 닿게 하기	1
소이 방에 알람 울리렴	소이 방에 알람 울리기	1
장외 종목은 제외 시키세요	장외 종목 제외하기	1
오늘밤 심야 영화 보자	오늘밤 심야 영화 보기	1
따뜻한 과일 차 어때 감기에는 즉효야	따뜻한 과일 차 먹기	1
욕심 부리지 말고 제 때 팔아 	제때 팔기	2
동묘역이야 네 정거장 남았다 조금만 기다려	조금만 기다리기	1
날씨 좋은 주말인데 야외로 사진이나 찍으러 가자	야외로 사진 찍으러 가기	1
현관문 열어주라	현관문 열기	1
판로를 다각화할 필요가 있어	판로 다각화하기	1
새 메일 중 정보라는 단어가 든 이메일 얼마나 되는지 확인해	새 메일 중 정보라는 단어 든 이메일 수	1
보일러 온수로 켜	보일러 온수로 켜기	1
궁금하신 사항은 기획담당관 실로 문의하시기 바랍니다	궁금한 사항은 기획담당관실로 문의하기	1
한남대교 정체상황을 알려	한남대교 정체상황	1
티브이 입력단자를 비디오 삼으로 바꿔 주겠니	티브이 입력단자를 비디오 삼으로 바꾸기	1
해가 너무 쨍쨍 나서 뜨거우니까 모자 써	모자 쓰기	1
지금 영동 고속도로 정체상황을 알자	지금 영동고속도로 정체상황	1
전자지도 서비스를 이용할 수 있는지 알려라	전자지도 서비스 이용 가능 여부	1
공부하기가 너무 싫어서 그러니까 잠시 쉬자	잠시 쉬기	1
너 이번에 승진되었다며 한 턱 쏴야지	한 턱 쏘기	1
좋은 주식을 사서 장기간 보유하세요	좋은 주식 사서 장기간 보유하기	1
너도 여윳돈 있으면 그냥 안전하게 은행에 저축해 놔	안전하게 은행에 저축해 놓기	1
장외거래로 팔아 주실 수 있으세요	장외거래로 팔기	1
춥다고 마음도 웅크리면 안 돼	춥다고 마음 웅크리기	0
조금만 기다려 주세요	조금만 기다리기	1
저녁 같이 먹고 싶다	저녁 같이 먹기	1
화요일 일정을 일부 변경	화요일 일정 일부 변경하기	1
차안에서 뭐 먹으면 안돼	차안에서 뭐 먹기	0
디브이디 꺼내줄래	디브이디 꺼내주기	1
우리 오늘은 심야영화로 보자	오늘은 심야영화로 보기	1
화보 기사를 보여라	화보 기사	1
반포대교 구간 우회도로 정보를 알려라	반포대교 구간 우회도로 정보	1
좋은 과외 선생님 소개 시켜 줄래 	좋은 과외 선생님 소개하기	1
일하기 싫으면 반차 내고 놀러 가자	반차 내고 놀러 가기	1
이렇게 더운데 숲 한가운데 가있으면 좀 덜하지 않을까 	숲 한가운데 가기	1
동휘에게 연락 왔는데 외로우니까 편지 좀 많이 하래	동휘에게 편지 많이 하기	1
그만 멈춰라	멈추기	1
안 봐	보기	1
이번 가을 기상 전망을 보여줄래	이번 가을 기상 전망	1
그 쇼핑몰 업데이트 됐어 들어가서 봐	쇼핑몰 들어가서 보기	1
좀 더 튕겨 보는 게 좋을듯해	좀 더 튕겨 보기	1
추우니까 옷 두껍게 입고 나가	옷 두껍게 입고 나가기	1
잠깐 뵙고 싶은데 지금 안 될까요 	잠깐 보기	1
이박 삼일 예약을 취소해	이박 삼일 예약 취소하기	1
성수 제이시 부근은 정체 구간인지 파악해주렴	성수 제이시 부근 정체 구간 여부	1
김기에는 휴식이 최고의 처방이야 푹 쉬어	푹 쉬기	1
요점만 간단히 말해주시면 학습에 도움이 되겠습니다	요점만 간단히 말해주기	1
외국 나갈 땐 비상약은 챙겨가	외국 나갈 때 비상약 챙겨가기	1
성적에 이의 있으면 일주일 내로 질문하세요	성적 이의 있으면 일주일 내로 질문하기	1
어제 두산 베어스 팀 경기 관련 기사 검색	어제 두산 베이스 팀 경기 관련 기사	1
래프팅 하러 가자	래프팅 하러 가기	1
복날인데 삼계탕 먹어야지	삼계탕 먹기	1
내일 사진촬영 부탁해도 괜찮을까	내일 사진촬영해주기	1
추석특집 영화 관련 소식 보여라	추석특집 영화 관련 소식	1
나 휴가 나가니까 마중 나와 있어	마중 나오기	1
성남 일화의 최근 기사를 보여	성남 일화의 최근 기사	1
맵고 짠 음식은 건강에 해로워	맵고 짠 음식 먹기	0
너두 청약 걸어	청약 걸기	1
항상 그렇게 연락도 없는데 누가 네 안부를 묻겠니 	연락하기	1
맨날 맨날 이렇게 싸우지 말자	맨날 싸우기	0
암벽등반도 위험하다	암벽등반하기	0
오빠 오랜만에 봐서 너무 반가웠어요 우리 앞으로 자주 봐요	앞으로 자주 보기	1
주식을 살 때는 여러 차례에 걸쳐 나누어 사야해	주식을 살 때는 여러 차례에 걸쳐 나누어 사기	1
최근 박찬호 경기 관련 기사 찾아	최근 박찬호 경기 관련 기사	1
이번에 업무협약을 체결 합시다	이번에 업무협약 체결하기	1
저녁 같이 합시다	저녁 같이 하기	1
시험공부도 좋지만 몸 생각해서 일찍 자둬	일찍 자기	1
궉채이 관련 기사 모아주렴	궉채이 관련 기사	1
전화 요금 자동 이체 해 놓으면 좋아	전화 요금 자동 이체 해 놓기	1
라디오의 볼륨을 오 단계 높여주련	라디오 볼륨 오 단계 높이기	1
담배 좀 그만 피워요 나쁘다는 거 알면서 이제 끊어요	담배 피우기	0
어젯밤 도착한 이메일을 모두 보여라	어젯밤 도착한 이메일 모두	1
바쁘다고 신호를 지키지 않고 운전하면 안돼요	신호 지키지 않고 운전하기	0
와우 함박눈 목도리 장갑은 필수	목도리 장갑 준비하기	1
전자렌지를 작동시켜줄래	전자레인지 작동시키기	1
주말에 촌에 감 따러 매형이랑 같이 내려와요	주말에 매형이랑 같이 내려오기	1
경제의 흐름을 알아야 됩니다	경제의 흐름 알기	1
안방으로 가서 이비에스 켜줄래	안방으로 가서 이비에스 켜기	1
여름이라도 재킷정도는 챙겨가야되	재킷 챙겨가기	1
언니 라면만 먹지 말고 귀찮아도 밥 꼭 챙겨먹어	밥 챙겨먹기	2
송파 신도시개발 관련 뉴스를 모두 찾아라	송파 신도시개발 관련 뉴스	1
인적사항 정확히 확인 바랍니다	인적사항 정확히 확인하기	1
아직 쌀쌀하니까 옷 잘 챙겨 입고	옷 잘 챙겨 입기	1
박찬호 올해 성적 관련 기사 찾아다오	박찬호 올해 성적 관련 기사	1
초기화 상태로 가라	초기화 상태로 가기	1
신제품 설명회 있으니 세시까지 회의실로 와	세시까지 회의실로 오기	1
경영 도서관에 자리 맡아놨어 한 턱 쏴라	한턱 쏘기	1
절대 안돼	하기	0
외교통상부 장관에 대한 뉴스를 보여주렴	외교통상부 장관 뉴스	1
주식 경험이 없으면 모의 주식을 한번 해봐	모의 주식 한번 해보기	1
대리운전 불러	대리운전 부르기	1
오늘 주요 경기 알리렴	오늘 주요 경기	1
대략 그 때까지 모두 완성 해보시죠	그 때까지 모두 완성하기	1
생일 축하합니다 한 턱 쏴라	한 턱 쏘기	1
오늘은 일찍 가서 푹 쉬지 그래	일찍 가서 쉬기	1
슈퍼마켓에서 콜라 좀 사올래	슈퍼마켓에서 콜라 사오기	1
에어컨 희망온도 이십 육 도로 맞춰	에어컨 희망온도 이십 육 도로 맞추기	1
영화티켓 생겼어 영화 보러 가자	영화 보러 가기	1
출입고계획서를 제출하여 주시기 바랍니다	출입고계획서 제출하기	1
홍대에 만화책 사러 갈 건데 같이 갈래 	홍대에 만화책 사러 같이 가기	1
저기 뜨거운 물을 들어서 이리 가지고와	뜨거운 물 들어서 이리 가지고오기	1
만나서 같이 학교에 갈래 	만나서 같이 학교 가기	1
오늘 과외 있으니까 같이 나가자	같이 나가기	1
내 컴퓨터에 있는 도면 중에서 찾아봐	내 컴퓨터에 있는 도면 중에서 찾아보기	1
이렇게 더운 날은 이열치열이라고 삼계탕이나 먹자	삼계탕 먹기	1
카페인 섭취를 너무 많이 하지 마	카페인 섭취 많이 하기	0
우리 여행 계 만들어 돈 모아서 해외여행 가자	여행 계 만들어 돈 모아서 해외여행 가기	1
종목의 선택이 특히 중요해	종목 선택 잘 하기	1
십이월 오일까지 납부 마감	십이월 오일까지 납부 마감하기	1
무엇보다 교통 법규를 지키는 게 가장 중요한 거야	교통 법규 지키기	1
오늘 일곱 시에 긴급 회의 합니다	오늘 일곱 시에 긴급 회의하기	1
김 과장님 퇴근 후에 한잔 할까요	퇴근 후에 한잔 하기	1
교통법규를 잘 지킬 필요가 있어요	교통법규 잘 지키기	1
현재 풍랑 경보 해제 지역을 알려	현재 풍랑 경보 해제 지역	1
머리 아프면 집에 가서 쉴 수 있도록 조치합니다	머리 아프면 집에 가서 쉴 수 있도록 조치하기	1
햇빛이 강하니 모자를 준비해 와라	모자 준비하기	1
사과 껍질로 마사지를 한 번 해봐	사과껍질로 마사지해보기	1
다리에 쥐가 나서 전혀 걸을 수 없어 마중 나올래	마중나오기	1
엘리베이터보다는 계단을 이용해	엘리베이터보다는 계단 이용하기	1
내부 순환도로 교통상황을 알려	내부 순환도로 교통상황	1
오늘 밤까지 단어를 모두 외우기로 했던 거 기억해 	오늘 밤까지 단어 모두 외우기	1
경부 고속도로에 노면이 결빙된 구간은 어딘지 보여라	경부고속도로에 노면이 결빙된 구간	1
거래소는 십 주씩 사야 해	거래소 십 주씩 사기	1
강아지와 함께 거실을 한 바퀴 돌아	강아지와 함께 거실 한바퀴 골기	1
수화물 표를 보여주실래요	수화물 표 보이기	1
저 내일 졸업해요 많이 와 주실 거죠 	졸업에 와 주기	1
허재의 미국 연수에 관한 기사를 찾아줄래	허재의 미국 연수 관한 기사	1
여기는 낭떠러지 이오니 기대지 마십시오	기대기	0
시계탑 앞에서 일곱 시까지 볼 수 있어 	시계탑 앞 일곱 시에 보기	1
지금 포토샵 공부 중이데 같이 하자	포토샵 공부 같이 하기	1
천천히 말씀해주실래요	천천히 말하기	1
택배 잘 도착했나요 연락주세요	연락 주기	1
오늘 저녁에 외식한다고 너 빨리 들어오래	오늘 저녁 빨리 들어오기	1
분명히 해	분명히 하기	1
다음 시즌엔 꼭 야구 보러가기로 약속했어 	다음 시즌 야구 보러가기	1
잊지마	잊기	0
어제 삼성 라이온즈 관련 기사 모아볼래	삼성 라이온즈 관련 기사	1
부장급 회의니까 참석해	회의 참석하기	1
재활 훈련 동안 너무 무리하지 말고 좋은 음식 많이 먹어라	좋은 음식 많이 먹기	2
가만있어봐 우선 먼저 생각하고 움직이자	먼저 생각하고 움직이기	2
기도 제목을 함께 공유해 주시기 바랍니다	기도 제목 함께 공유하기	1
인라인 타자	인라인 타기	1
방금 전 채널로	방금 전 채널로 돌리기	1
이치로 선수 홈런에 관한 기사를 보여주련	이치로 선수 홈런 관한 기사	1
회식은 지난번 그 뷔페에서 하는 걸로 하죠	회식 지난번 그 뷔페에서 하기	1
비 오는데 차는 왜 가지고 다녀 위험했잖아	비 오는데 차 가지고 다니기	0
전문투자자들의 조언을 들어 봐	전문 투자자들의 조언 듣기	1
일교차 심해 건강에 유의해	일교차 심해 건강에 유의하기	1
다른 것 필요 없고 대리는 그냥 지시대로만 해	지시대로만 하기	1
한번만 그 운동을 해보도록 해봐	한번만 그 운동 해보기	1
오디오 볼륨 좀 낮춰주라	오디오 볼륨 낮춰주기	1
가스레인지 꺼졌는지 좀 보고와라	가스레인지 꺼졌는지	1
밤 열두시면 텔레비를 꺼주겠니	밤 열두시면 텔레비 꺼주기	1
기름이 부족하네 주유소 좀 들리자	주유소 들리기	1
전화하기 싫으면 문자라도 해	문자라도 하기	1
디브이디 꺼내	디브이디 꺼내기	1
교수님 한번 찾아 뵙자	교수님 찾아뵙기	1
너무 졸려도 갓길에서 차 세우지 마 위험해	갓길에서 차 세우기	0
물감과 팔레트를 챙겨오면 돼	물감과 팔레트 챙겨오기	1
현관 앞 감시해	현관 앞 감시하기	1
눈도 이렇게 오는데 웬만하면 그냥 택시 타고 와	택시 타고 오기	1
보관함에 있는 이메일 제목 중 케이티가 포함된 이메일을 삭제 해줄래	보관함에 있는 이메일 제목 중 케이티가 포함된 이메일 삭제하기	1
퇴직급여 안내서 오늘까지 부탁 드립니다	퇴직급여 안내서 오늘까시 주기	1
휴가계획서 양식은 온라인으로 다운 받으세요	휴가계획서 양식 온라인으로 다운받기	1
오늘 과외 미뤘으면 하는데	오늘 과외 미루기	1
번호표 뽑고 기다리고 있어	번호표 뽑고 기다리기	1
빌려서 막아야지	빌려서 막기	1
안방 선풍기 취침모드로 바꿔줄래	안방 선풍기 취침모드로 바꾸기	1
내일 아침 일찍 인쇄소에 들려줬음 하더라 	내일 아침 일찍 인쇄소에 들르기	1
상한가일 때 빨리 팔아버려	상한가일 때 빨리 팔기	1
밥은 내려가서 먹어요 	밥 내려가서 먹기	1
오해 하지마	오해하기	0
내방 저장화면을 보여라	내방 저장화면	1
세탁기를 삶음으로 돌려	세탁기 삶음으로 돌리기	1
대림님께 팩스 온 서류 빨리 가져오라 해	대림님께 팩스 온 서류 빨리 가져오라 하기	1
어젯밤 새 메일 중 아이디 토니가 보낸 이메일 찾아줄래	어젯밤 새 메일 중 아이디 토니가 보낸 이메일	1
빼먹지 말고 다 챙겨와	다 챙겨오기	2
전국의 주간 날씨를 알려줄래	전국 주간 날씨	1
건강 유지를 위해 이 사과 하나 먹어 봐	이 사과 하나 먹어 보기	1
성경과 숲을 큐티하는 시간 참석 바랍니다	성경과 숲을 큐티하는 시간 참석하기	1
일어나세요	일어나기	1
항상 몸 상태를 신경쓰세요	항상 몸 상태 신경쓰기	1
빨리 와야돼	빨리 오기	1
단수 예정이래 물 많이 받아 놓아야 해	물 많이 받아 놓기	1
언어순화 운동에 동참해 주세요 메일 보내드리겠습니다	언어순화 운동에 동참하기	1
거실의 커튼을 닫어	거실의 커튼 닫기	1
일년 뒤에 이 자리에서 만나	일년 뒤에 이 자리에서 만나기	1
엘루이 호텔 특실 예약 부탁해	엘루이 호텔 특실 예약하기	1
너 자신과의 약속은 꼭 지키도록 해	자신과의 약속 지키기	1
공원 옆에 있는 샛길로 계속 직진 하면 보일 거야	공원 옆 샛길로 계속 직진하기	1
오해 하지마	오해하기	0
귀찮아도 칫솔질 열심히 해	칫솔질 열심히 하기	1
술집 예약해 뒀으니까 내일 여덟 시까지 상인 네거리로 와	내일 여덟 시까지 상인 네거리로 오기	1
유아나 소아의 손이 닿지 않는 곳에 보관하십시오	유아나 소아의 손이 닿지 않는 곳에 보관하기	1
오늘의 일 면 기사를 찾아	오늘의 일 면 기사	1
차라리 외국 여행 나가려는 사람들한테 직접 파는 건 어때	외국 여행객들에게 직접 팔기	1
작은방 온도를 높여주렴	작은방 온도 높이기	1
신천역 옆 맥도날드 앞으로 나와	신천역 옆 맥도날드 앞으로 나오기	1
이번 주 금요일에 월차 쓰고 스키장 가기로 약속 한거다	이번 주 금요일 스키장 가기	1
까쓰레인지의 까쓰를 열어	까쓰레인지의 까쓰 열기	1
거래명세서 정리하고 출력해 오세요	거래명세서 정리하고 출력해 오기	1
내리실 때 뒤쪽의 오토바이를 조심하세요	내릴 때 뒤쪽의 오토바이 조심하기	1
동아일보 사회면을 보여라	동아일보 사회면	1
스킨스쿠버 하기로 한 날이 내일이야 장비 챙겨 와	내일 스킨스쿠버 장비 챙겨오기	1
우리 가까운 교외로 드라이브 가자	가까운 교외로 드라이브 가기	1
버스 타니까 정류장에서 봐	정류장에서 보기	1
이거 도대체 누가 작성한 거야 책임자 불러와 	이거 책임자 불러오기	1
간 약한 불로 익혀	간 약한 불로 익히기	1
아파트 청약 걸어놨데 너두 청약 걸어	아파트 청약 걸기	1
할인쿠폰 있으니까 그리 가자	그리 가기	1
십 분 뒤면 은행 문 닫는다고 하니 빨리와	빨리 오기	1
사원 여러분들의 많은 관심 부탁드립니다	관심 가지기	1
이십 키로 짜리 한 통이 필요해	이십키로짜리 한 통 가져오기	1
소주 한잔 하고 싶어 나올 수 있어	소주 한잔 하기	1
각 학교별로 할당된 포스터 붙이고 결과 보고 해주세요	각 학교별로 할당된 포스터 붙이고 결과 보고하기	1
비 올지도 모르니까 세차는 미뤄둬	세차 미뤄두기	1
요즘 고민이 너무 많아 만나서 얘기하자	만나서 얘기하기	1
샤라포바와 관련된 테니스 경기 기사 찾아	샤라포바 관련 테니스 경기 기사	1
보내주신 서류에 누락된 것이 있습니다 확인 바랍니다	서류 확인하기	1
주말인데 그냥 집에 들어가지 말고 외식이라도 하자	외식하기	1
장소 바꾸지마 금방 갈께	장소 바꾸기	0
래프팅 하러 가자	래프팅하러 가기	1
내일까지 내 투자론 책 가져오는 것 잊지 마	내일까지 내 투자론 책 가져오기	1
오늘 종강이래 학교 꼭 와	오늘 학교 꼭 오기	1
목욕탕은 함부로 가면 안 되는 거야	목욕탕 함부로 가기	0
김포공항으로 들어가는 도로 상황을 알리렴	김포공항 들어가는 도로 상황	1
티브이 입력단자를 비디오 삼으로 바꿔 주겠니	티브이 입력단자 비디오 삼으로 바꾸기	1
지금 뉴스에 주식에 대한 거 나오니까 빨리 봐	지금 뉴스 보기	1
어젯밤 새 메일 중 정자가 보낸 이메일을 찾아	어젯밤 새 메일 중 정자가 보낸 이메일	1
우리 점심 때 냉면 먹으러 가자	점심 때 냉면 먹으러 가기	1
모두 전자제품을 꺼주련	전자제품 끄기	1
그냥 좀 버텨 봐 취직하기 힘들어	버텨 보기	1
추석 때는 조상님께 차례를 지내야 해	추석 때 조상님께 차례 지내기	1
재건축 바람에 대한 기사를 찾아라	재건축 바람 기사	1
요점 정리한 노트 내일 갖다줄 수 있어	요점 정리한 노트 내일 갖다주기	1
여름옷이 없어 같이 쇼핑가자	같이 쇼핑가기	1
새 메일 중 주문 확인 이메일이 있는지 확인해줄래	새 메일 중 주문 확인 이메일이 있는지	1
공부하다 힘들면 바람 좀 쐬면서 해	바람 쐬면서 하기	1
그거 여기 두시고 좀 앉으셔서 뭐 한 잔 드세요	여기 두고 앉아서 쉬기	1
십일월 오일 공연 보러 가자	십일월 오일 공연 보러 가기	1
거기 서라	서기	1
헬스장 등록해주는 정도의 센스가 필요함	헬스장 등록해주기	1
테레비 꺼주겠니	테레비 끄기	1
안 움직여	움직이기	1
약속의 중요성을 일깨워주는게 좋지 않을까요	약속의 중요성 일깨우기	1
좌우를 살피고 횡단보도를 건너야 합니다	좌우를 살피고 횡단보도 건너기	1
천천히 가세요	천천히 가기	1
먼저 들어가 쉬어 내가 뒷정리 하고 갈게 	먼저 들어가 쉬기	1
신제품 발표회를 다음 기회로 미룹시다	신제품 발표회를 다음 기회로 미루기	1
십이월 사일 바캉스 가자	십이월 사일 바캉스 가기	1
강원도컵 아이스하키 기사를 찾아볼래	강원도컵 아이스하키 기사	1
사업계획서를 한번 보여주면 생각해보기로 할게	사업계획서 보여주기	1
안방 온도를 이십 사 도로 맞춰주련	안방 온도 이십사도로 맞추기	1
짜증내지마	짜즈앤기	0
과음 하지마 적당히 마셔	과음하기	0
정 불안하면 그냥 정기예금에 넣어버리든가	정기예금에 넣어버리기	1
군대 와서의 첫 휴가 잘 보내고 오게나	휴가 잘 보내고 오기	1
워크숍 준비 열심히 하고 있어요 	워크숍 준비 열심히 하기	1
오전 일곱시에 라디오 켜주겠니	오전 일곱시에 라디오 켜기	1
회비는 이번 주 내로 완납 부탁드립니다	회비 이번 주 내로 완납하기	1
강풍으로 해주라	강풍으로 하기	1
내일 선생님 뵈러 학교 가자	내일 선생님 뵈러 학교 가기	1
졸업 축하 하고 사회에 큰 그릇이 되라	사회에 큰 그릇 되기	1
나와 있어	나와 있기	1
오늘 만나고 싶어요 정오에 만났으면 합니다	오늘 정오에 만나기	1
팥빙수 먹을 때 나 안 부르면 알지	팥빙수 먹을 때 부르기	1
세시간 뒤에 부산역에서 만납시다	세시간 뒤 부산역에서 만나기	1
학원에서 예습했다고 수업 시간에 졸면 안돼	수업 시간에 졸기	0
그 연구 보고서 내 것도 복사 할 수 있으면 부탁 좀 할게	연구 보고서 복사하기	1
대북 쌀지원 관련소식을 찾아줄래	대북 쌀지원 관련소식	1
반신욕 하고 양말 신고 있으면 좋대	반신욕 하고 양말 신고 있기	1
뮤지컬 표가 두 장 생겼는데 이번 주에 같이 갈래	뮤지컬 이번 주에 같이 가기	1
조금만 기다려	조금 기다리기	1
티비 메뉴 보여주겠니	티비 메뉴	1
마지막 폐업 정리합니다 이번 기회에 하나 장만하세요	이번 기회에 하나 장만하기	1
아이보 현관으로 이동해	현관으로 이동하기	1
잠시만 기다리십시오 곧 연결시켜 드리겠습니다	기다리기	1
컴퓨터 잘 다루고 싶은데 같이 컴퓨터 학원 다닐까 	같이 컴퓨터 학원 다니기	1
한강에 유람선 타러 가자	한강에 유람선 타러 가기	1
결재서류 빨리 올려 보내세요	결재서류 빨리 올려보내기	1
남산터널이 붐비는지 알고싶어	남산터널이 붐비는지	1
눈 온다던데 장갑이랑 모자 챙겨와	장갑 모자 챙겨오기	1
샤라포바에 대한 기사를 보자	샤라포바 기사	1
축구 주간 엠브이피에 관한 기사를 찾아줄래	축구 주간 엠브이피 기사	1
큰 돈을 투자하는 건 위험해	큰 돈 투자하기	0
이제 잠수 끝 얼굴 좀 보자	얼굴 보기	1
서울대 앞 우동 전문점 위치를 알려	서울대 앞 우동 전문점 위치	1
밀린 세금은 이번 주 안으로 납부하세요	밀린 세금 이번주 안으로 납부하기	1
레저 스포츠의 종류에 대해서 알고 싶어요	레저 스포츠의 종류	1
일어나세요	일어나기	1
짐이 많으니까 그 앞에 나와있어	그 앞에 나와있기	1
가능하면 대기업의 주식을 사서 장기투자를 하세요	대기업의 주식을 사서 장기투자하기	1
이번 주 목요일 저녁 일곱 시 유신학원 앞이다	이번 주 목요일 저녁 일곱 시 유신학원 앞에서 보기	1
이번 프리젠테이션은 김기수씨가 하세요	이번 프리젠테이션 하기	1
다음번에는 횟집에서 모이자 잘 들어가	다음번엔 횟집에서 모이기	1
지금 테니스 한 게임 할까	테니스 한 게임 하기	1
현관문 모니터 켜라	현관문 모니터 켜기	1
그래도 안되면 그래픽카드를 다시 유심히 살펴보라	그래픽카드 유심히 살펴보기	1
신용카드 약관 꼭 읽어봐	신용카드 약관 읽기	1
다른 나라의 교육 방식을 본받아 학습시켜보자	다른나라의 교육방식을 본받아 학습시키기	1
회의 끝나고 커피나 한잔 하게 휴게실로 와	회의 끝나고 휴게실로 오기	1
열차표 예약해	열차표 예약하기	1
오늘 학교 끝나고 피씨방 가자	오늘 학교 끝나고 피씨방 가기	1
이메일 제목에서 물리학개론이 들어가 있는 것 모두 검색 해볼래	이메일 제목에서 물리학개론이 들어가 있는 것 모두	1
교회 사기에 대한 기사를 찾아라	교회 사기 대한 기사	1
소비자 보호원에 대한 뉴스를 모두 보여라	소비자 보호원 뉴스	1
그러면 남부순환도로따라 운전해 오세요	남부순환도로 따라 운전해 오기	1
오늘 고생 많으셨어요 푹 쉬세요	푹 쉬기	1
마지막 한 주 알차게 보내보자	마지막 한 주 알차게 보내기	1
허리 조심해 삐끗하기 쉬워	허리 조심하기	1
벽제 병원에 나 입원했다 한번 와라	벽제 병원에 한번 오기	1
현재 호우 주의보가 해제된 지역을 보이렴	현재 호우 주의보가 해제 지역	1
헹굼 세 번 해줄래	헹굼 세 번 하기	1
얼어붙지 않도록 세차하실 때 조심하세요	세차할 때 조심하기	1
예의바르게 인사하는 습관을 기르세요	예의바르게 인사하기	1
작은방에 불 좀 켜주겠니	작은방 불 켜기	1
대회 참가비는 모두 총무에게 내어 주세요	대회 참가비 총무에게 내기	1
입사 전에 복리후생이 잘되는지 꼭 확인해봐	입사 전 복리후생 잘되는지	1
지금 십 일번 채널 봐봐 아까 촬영한 거 나온다	지금 십일번 채널 보기	1
정확한 분석과 평가 하에 투자를 해야 될 거다	정확한 분석과 평가 하게 투자하기	1
교수님이 과제 월요일까지 내라고 하셨어	과제 월요일까지 내기	1
오늘 동아일보 주요 사설을 보자	오늘 동아일보 주요 사설	1
업무 분장을 확실히 해 주십시오	업무 분장 확실히 하기	1
정말 더운건 너무 싫다니깐 찬물에 샤워나 하자	찬물에 샤워하기	1
전자렌지를 라면 끓이는 모드로 작동시켜 주렴	전자레인지를 라면 끓이는 모드로 작동하기	1
추석 때 가족들 먹을 과일 사러 가락시장 가자	가락시장 가기	1
해약 하려면 그 은행 삼층에 가야해	해약하려면 그 은행 삼층 가기	1
인적사항 정확히 확인 바랍니다	인적사항 정확히 확인하기	1
아이디와 패스워드를 확인 후에 다시 이용바랍니다	아이디와 패스워드 확인 후 이용하기	1
그거 대출 받으려면 그 서류 꼭 가져가라	그 서류 꼭 가져가기	1
주유 비용은 회사에서 모두 청구하세요	주유 비용 회사에서 모두 청구하기	1
감기에는 쉬는 게 최고야	쉬기	1
어머니와 저녁약속이 있으니까 너도 꼭 와야 해	꼭 오기	1
내일 가족 예배 있으니까 일찍 들어와	내일 일찍 들어오기	1
수목 드라마 관련 소식 알려라	수목 드라마 관련 소식	1
약속 장소를 수정해	약속 장소 수정하기	1
내일 야참이나 같이 먹죠	내일 야참 같이 먹기	1
뮤지컬 시작하기 전에 문화회관으로 오도록 해	뮤지컬 시작하기 전에 문화회관으로 오기	1
그런 마음가짐으로는 서비스 업에 종사할 수 없어	그런 마음가짐 가지기	0
어젯밤 새 메일 중 정자가 보낸 이메일을 찾아줄래	어젯밤 새 메일 중 정자가 보낸 이메일	1
나무는 심는 거보다 가꾸는 게 더 중요 연락 자주해	연락 자주하기	1
너 주식 한다면서 너무 빠지지는 마라 걱정된다	주식에 빠지기	0
장애인 전용 주차 구역의 이용 실태를 알아보자 	장애인 전용 주차 구역 이용 실태	1
무리 하지마	무리하기	0
이치로 선수의 홈런에 관한 기사를 알려	이치로 선수 홈런 기사	1
내일부터 백화점 세일인데 같이 쇼핑 갈래 	내일 백화점 같이 가기	1
그냥 빼는 게 제일 좋지 않을까	그냥 빼기	1
말 뿐인 약속이라면 이제 필요 없어	말뿐인 약속하기	0
이마트 주차장이야 칠 층으로 와	이마트 주차장 칠층으로 오기	1
어제부터 시작된 품평회에 참석율이 저조합니다 참석바랍니다	품평회 참석하기	1
커튼 반만 열어라	커튼 반만 열기	1
피파랭킹 관련 기사 보여	피파랭킹 관련 기사	1
이번 연휴에는 하루만 추가해서 쉬어	이번 연휴 하루만 추가해 쉬기	1
텔레비전 켜라	텔레비전 켜기	1
작은방 방문 닫아	작은방 방문 닫기	1
아테네 올림픽에서 수영과 관련된 기사를 찾아라	아테네 올림픽 수영 관련 기사	1
티비 색 보정해주라	티비 색 보정하기	1
청와대 소식 보여주렴	청와대 소식	1
내일 원서 쓰는 날이야 돈 가져와	돈 가져오기	1
아침에 나오기 전에 일기예보 꼭 시청하고 나와	나오기 전 일기예보 시청하기	1
뒷정리는 다같이 합니다	뒷정리 다같이 하기	1
수영대회 꼭 우승해서 상금 받으면 한 턱 쏘세요	수영대회 우승해서 상금 받으면 한 턱 쏘기	1
이메일 오빠한테 보내	이메일 오빠한테 보내기	1
영화 끝나면 저에게 전화 주세요	영화 끝나면 전화 주기	1
각종 질병예방을 위해 손을 씻어 주세요	손 씻기	1
열시에 선풍기 꺼주겠니	열시에 선풍기 꺼주기	1
이틀이요	이틀 주기	1
다음번에는 횟집에서 모이자 잘 들어가	다음번에는 횟집에서 모이기	1
좌석을 좀 예약하려고 하는데요	좌석 예약하기	1
여름철엔 식중독에 유의한다	여름철 식중독 유의하기	1
열 바퀴 뛰고 나서 다시 해요	열 바퀴 뛰고 나서 다시 하기	1
날씨가 너무 좋으니 공원에 김밥 싸가지고 놀러 가자	공원에 김밥 싸가지고 놀러가기	1
셋을 셀 때까지 튀어나와	셋 셀 때까지 튀어나오기	1
힘들게 운전했는데 좀 쉬렴	좀 쉬기	1
폰뱅킹 계약을 체결하셔야 합니다	폰뱅킹 계약 체결하기	1
어젯밤 새 메일 중 알림 이메일을 찾아라	어젯밤 새 메일 중 알림 이메일	1
왜 문자 안해	문자하기	1
내일 정말 춥대 목도리 매고 가	내일 목도리 매고 가기	1
내일부터 백화점 세일인데 쇼핑하러 가자	쇼핑하러 가기	1
오늘 조선일보의 띠별 운세 보여	오늘 조선일보 띠별 운세	1
아빠 옆에 있어라	아빠 옆에 있기	1
안방 테레비 이십 사 번으로 돌려주겠니	안방 테레비 이십 사 번으로 돌리기	1
찬 바람 쐬면 감기 걸리기 쉬우니 조심해	찬 바람 쐬기	0
내가 장 봐왔으니까 넌 그냥 와	그냥 오기	1
이십일 열두시 잠실대교 흐름을 보여주렴	이십일 열두시 잠실대교 흐름	1
조명 조금 어둡게 해주라	조명 조금 어둡게 하기	1
전에 빌려 준 돈 이번 주까지 좀 갚아	전에 빌려준돈 이번주까지 갚기	1
케이비에스일 티비로 돌려	케이비에스일 티비로 돌리기	1
쇼핑하러 코엑스 가기로 한 거 안 잊었지	쇼핑하러 코엑스 가기	1
현재 한국 프로야구 순위 현황을 보여라	현재 한국 프로야구 순위 현황	1
잠실대교 소통을 보여주렴	잠실대교 소통 보여주기	1
주유하고 있어 얼른 갈게	주유하고 있기	1
공식을 이해해야지 외우지 마라	공식 이해하기	2
할인되는 요일 있는지 확인해	할인되는 요일 있는지	1
시험 범위가 다시 바뀌었으니 알아 가세요	시험 범위 알아가기	1
소이 방 알람 울려	소이 방 알람 울리기	1
우리는 모두 하나로 뭉쳐야만 버텨낼 수 있습니다	하나로 뭉치기	1
수수료는 네가 물기로 했잖아	수수료 물기	1
문막 휴게소에서 만난다	문막휴게소에서 만나기	1
투다리에서 한 시간 뒤에 보자	투다리에서 한 시간 뒤에 보기	1
여의도 벚꽃놀이 가지 않을래	여의도 벚꽃놀이 가기	1
저기 잠깐만요	기다리기	1
야유회에 개인 돗자리를 꼭 가져오세요	야유회에 개인 돗자리 가져오기	1
불 다 꺼	불 다 끄기	1
고양이 어딨는지 좀 찾아라	고양이 찾기	1
추가된 일정에 해당되는 사람은 누군지 알려다오	추가 일정 해당되는 사람	1
골프 치러 가자	골프 치러 가기	1
대회 참가비는 모두 총무에게 내어 주세요	대회 참가비 총무에게 내기	1
지금 외근 나왔는데 잠깐 얼굴이나 볼까 	잠깐 얼굴 보기	1
믿어 줘 정말이야	믿어 주기	1
교통 법규 위반 하지 마	교통 법규 위반하기	0
감기엔 모과차가 좋대요	모과차 먹기	1
잘 알아보고 이용해	잘 알아보고 이용하기	1
티브이나 컴퓨터를 너무 가까이 보지 마세요	티브이나 컴퓨터를 너무 가까이 보기	0
가다가 휴게소에서 멈춰	가다가 휴게소에서 멈추기	1
전화기 사죠	전화기 사주기	1
그만한 곳 없다 그냥 버텨봐 다른 곳도 다 마찬가지다	그냥 버텨보기	1
업무 외 전화는 핸드폰을 이용해	업무 외 전화는 핸드폰 이용하기	1
라디오 볼륨을 사로 맞춰주겠니	라디오 볼륨 사로 맞추기	1
자수성가한 사업가의 특강이 있으니까 같이 가자	자수성가한 사업가의 특강 같이 가기	1
불량 작전 주에 휘말리지 않도록 계획을 세워야해	불량 작전 주에 휘말리지 않도록 계획 세우기	1
내일은 약속 잡지마	내일 약속잡기	0
되도록이면 앞 차 추월하지 말고 천천히 와	천천히 오기	2
현관 보여주라	현관 보이기	1
시월달 세계 기온을 보여줄래	시월달 세계 기온	1
신청기일을 꼭 확인하시고 이용 바랍니다	신청기일을 확인하고 이용하기	1
이번 달 받은 성인이라는 제목의 이메일 삭제할래	이번 달 받은 성인이라는 제목의 이메일 삭제하기	1
우리나라 양궁의 순위 관련 기사 검색	우리나라 양궁 순위 관련 기사	1
요즘 건강선물이 유행이라니 그걸 선물해	건강선물 선물하기	1
스미스 씨한테 저에게서 전화 왔었다고 좀 전해주실래요	스미스씨한테 전화왔었다고 전하기	1
우리 일광욕 하러 나가자	일광욕하러 나가기	1
정신 건강을 위해 스트레스는 그때 그때 풀자	스트레스 그때그때 풀기	1
냉장고 냉장 온도를 강으로 해줄래	냉장고 냉장 온도 강으로 하기	1
천연기념물 발견 기사를 찾아	천연기념물 발견 기사	1
임원회의 참석 여부를 알려 주십시오	임원회 참석 여부	1
더우니까 삼계탕으로 몸보신 하세요	삼계탕으로 몸보신하기	1
금강산 야생꽃에 대한 기사를 찾아라	금강산 야생꽃에 대한 기사	1
초희방 에어컨 이십 사 도로 맞춰주겠니	초희방 에어컨 이십사도로 맞추기	1
밥 해놔라	밥 해놓기	1
협상할 때는 둘 다 이기는 방법을 선택하기를 바래	둘 다 이기는 방법 선택하기	1
수상스키 같이 배워볼까	수상스키 같이 배우기	1
아가 장난감 치워죠	장난감 치우기	1
강남역 가는 길 좀 보자	강남역 가는 길	1
니가 술사야 만나 준다	술사기	1
몸도 찌푸둥하니 찜질방 가자	찜질방 가기	1
십 육 대 총선에 대한 소식을 보여라	십육대 총선 소식	1
관리사무실로 연결해 주겠니	관리사무실로 연결하기	1
감기엔 오렌지쥬스가 좋아	오렌지쥬스 마시기	1
고양이가 놀고 있는 모습을 찍어라	고양이가 놀고 있는 모습 찍기	1
상일 인터체인지에서 대전 인터체인지까지 가스충전소가 있는 휴게소는 몇 군데인지 알려주렴	상일 이터체인지에서 대전 인터체인지까지 가스충전소 있는 휴게소 수	1
어느 은행이든 비슷하지만 더 저렴한 은행으로 옮겨	더 저렴한 은행으로 옮기기	1
너도 통합 카드 하나 만들어 	통합 카드 하나 만들기	1
내일 오전 예상되는 적설량을 알려줄래	내일 오전 예상 적설량	1
봉석이 오빠도 너를 이해 할거야 너무 신경 쓰지마	너무 신경쓰기	0
금융정보 유료사이트는 사용할 때 주의해야 해	금융정보 유료사이트 사용할 때 주의하기	1
일 주일 사이 내가 읽지 않은 메일을 보여줄래	일 주일 사이 내가 읽지 않은 메일	1
야유회 장소가 변경 됐으니 홈페이지에서 확인 바랍니다	야유회 장소 확인하기	1
돈을 벌려면 코 묻은 돈부터 주워 모으자 	코 묻은 돈부터 모으기	1
혼자 끙끙대지 말고 영업팀과 업무를 나눠서 하세요	영업팀과 업무 나눠서 하기	2
오늘 오후에 올라가는 열차를 예약해	오늘 오후에 올라가는 열차 예약하기	1
오늘 황사가 심하데요 마스크 쓰고 다녀요	마스크 쓰고 다니기	1
꼬마냄비에 순두부 있으니까 그것도 데워 먹어라	꼬마냄비에 순두부 데워먹기	1
내일 부터 나랑 운동장 두 바퀴씩 달리자	내일부터 운동장 두 바퀴씩 달리기	1
날이 춥거나 더워도 할 일은 해야지	할 일은 하기	1
주식투자 하기 전에는 욕심을 버려	주식투자 하기 전에 욕심 버리기	1
흡연 관련 건강기사 찾을래	흡연 관련 건강기사	1
세탁기 물 중간으로	세탁기 물 중간으로 하기	1
곧 비 올 것 같다 일찍 들어와라	일찍 들어오기	1
할머니 할아버지방에 있는 사람들을 보여라	할머니 할아버지방에 있는 사람들 보이기	1
대출할 때는 너의 주거래 은행을 이용하는 것이 좋아	대출할 때 주거래은행 이용하기	1
어젯밤 새 메일 중 알림 이메일 찾아보렴	어젯밤 새 메일 중 알림 이메일	1
대한민국에 유명한 약골이 너무 무리를 하면 안 된다	무리하기	0
작은방 온도를 높여주렴	작은방 온도 높이기	1
오늘 보자	오늘 보기	1
전에 빌려 준 돈 이번 주까지 좀 갚아	전에 빌려 준 돈 이번 주까지 갚기	1
조정장이라 뒤타를 조심하는 게 좋을 거야	뒤타를 조심하기	1
소식을 하고 규칙적으로 운동을 해야 하는 것도 모르니 	소식하고 규칙적으로 운동하기	1
회의 후 연락주세요	회의 후 연락주기	1
비 올지도 모르니까 비 옷 하나 챙겨 오길	비옷하나 챙겨 오기	1
다음 정거장에서 내려 앞에 편의점 보이지 	다음 정거장에서 내리기	1
봉사 장학생 신청하실 분은 학과 사무실로 와요	봉사 장학생 신청하려면 학과 사무실로 오기	1
스톱옵션 대박을 기대하지 말자	스톱옵션 대박을 기대하기	0
화장실에 환풍기 꺼	화장실에 환풍기 끄기	1
가까운데로 바꾸자	가까운데로 바꾸기	1
길 안 막히니깐 그리로 와	그리로 오기	1
주파수 돌려줄래	주파수 돌리기	1
토요일 주말의 명화 시간에 티비를 켜 주겠니	토요일 주말의 명화 시간에 티비 켜기	1
교양수업 같이 들어가자	교양수업 같이 들어가기	1
난 이까짓 주식 한 장보다 당신의 미소를 원해요	미소짓기	1
투기가 아닌 투자를 해야 한다는 의미도 본인이 직접 깨달으셔야 합니다	투기가 아닌 투자하기	1
나 체한 것 같아요 약 좀 사다줘요	약 사다주기	1
외출 전 가스 밸브를 확인해 주시길 바랍니다	외출 전 가스밸스 확인하기	1
두통은 그냥 신경성이니까 마음 급히 먹지 말고 좀 쉬래	좀 쉬기	2
칼슘 좀 챙겨 먹으라구	칼슘 챙겨먹기	1
주식은 여윳돈으로 투자하세요	주식은 여윳돈으로 투자하기	1
수요 예배에 초빙강사 있으니 참석 바랍니다	수요 예배에 참석하기	1
일본 다녀와서 만나 일주일 뒤	일주일 뒤 만나기	1
핸드폰을 가지고 와서 충전기에 꽂아라	핸드폰 가지고 와서 충전기에 꽂기	1
공기업 채용 관련 정보를 찾아라	공기업 채용 관련 정보	1
유월 이십 사일에 생일잔치 합니다 꼭 오세요	유월 이십 사일 생일잔치 오기	1
어젯밤 새 메일 중 공지 이메일 찾아보렴	어젯밤 새 메일 중 공지 이메일	1
차는 건강음료야 많이 마셔	차 마시기	1
오늘 황사가 심하데요 마스크 쓰고 다녀요	마스크 쓰고 다니기	1
아무 일도 아냐 신경 쓰지마	신경쓰기	0
학생회 회의 있으니 다 모이세요	다 모이기	1
늦어도 금요일까지는 꼭 부쳐 주셔야 해요	늦어도 금요일까지 부쳐주기	1
야전 침대도 부탁해	야전 침대 준비하기	1
모임의 활성화를 위해 모두 노력해 주십시오	모임의 활성화를 위해 노력하기	1
집안의 공기를 환기해	집안 공기 환기하기	1
너랑 유람선 타러 가고 싶은데	유람선 타러 가기	1
인터넷에서 산 책 값 오늘 안으로 계좌이체 하는 거 잊으면 안 된다	인터넷에서 산 책 값 오늘 안으로 계좌이체하기	1
이치로 선수 홈런 기사를 알려주렴	이치로 선수 홈런 기사	1
커피숍에서 기다리고 있을게 끝나는 대로 와	끝나는 대로 커피숍으로 오기	1
현빈이라는 이름으로 이메일을 보내줄래	현빈이라는 이름으로 이메일 보내기	1
천천히 이선을 따라서 움직여	천천히 이선을 따라 움직이기	1
저녁에 만날 때 내가 빌려줬던 옷 가지고 와라	저녁에 빌려줬던 옷 가지고 오기	1
한강교량 구간의 통행 소요 시간은 얼마나 되는지 파악해주련	한강교량 구간 통행 소요 시간	1
티비 메뉴 보여주겠니	티비 메뉴	1
부담 갖지 마시고 한번 구경 와	한번 구경 오기	2
있다가 과외 선생님 오실 거니까 집에 있어	있다가 집에 있기	1
와인 파티에 오셔서 즐거운 시간 가지시길 바랍니다	와인파티에 오기	1
먹고 싶으면 연락해 사줄께	먹고 싶으면 연락하기	1
주말에 시간 있으면 야외로 나갈까	주말에 시간 있으면 야외로 나가기	1
조깅이 힘들면 빨리 걷기라도 해봐	빨리 걷기	1
비행기표 예약 하지마	비행기표 예약하기	0
그냥 화장품이나 하나 사죠	화장품 하나 사주기	1
주식은 여유 돈으로 투자해야지	 주식은 여유 돈으로 투자하기	1
있다가 보자	있다가 보기	1
은행에서 원하는 서류를 챙겨오세요	은행에서 원하는 서류 챙겨오기	1
효과적으로 대처할 수 있는 매매기준을 정해	효과적으로 대처할 수 있는 매매기준 정하기	1
중고 핸드볼 경기에 관한 기사를 뽑아주렴	중고 핸드볼 경기 관한 기사	1
에스피에스 고교동창 골프대회 다음주부터 꼭봐	에스피에스 고교동창 골프대회 다음주부터 보기	1
그냥 천천히 걷는 거 보다는 파워 워킹이 더 좋데	파워 워킹하기	2
이 주일 사이에 읽지 않은 이메일 보여라	이 주일 사이에 읽지 않은 이메일	1
가장 최근에 온 순서대로 메일을 보여줄래	가장 최근에 온 순서대로 메일 보이기	1
충고 듣기 싫으면 맘대로 해	충고 듣기	1
에어컨에 공기청정 기능 온 해	에어컨 공기청정 기능 온 하기	1
지난달 쇼핑 메일 전부 보여줄래	지난달 쇼핑 메일	1
까쓰오븐 백 삼십 도에 십 분 간으로 세팅해 주겠니	까쓰오븐 백 삼십 도에 십분 간으로 세팅하기	1
고속도로 현재 교통상황을 보자	고속도로 현재 교통상황	1
부장님 결재 서류 오늘까지 검토 해주셔야 하는데요	결재 서류 오늘까지 검토하기	1
김치 냉장고를 숙성으로 해다오	김치 냉장고 숙성으로 하기	1
시월 오일 오전 일곱시까지 나와	시월 오일 오전 일곱시까지 나오기	1
전화해	전화하기	1
티비 소리 내려줄래	티비 소리 내리기	1
햇볕이 따갑다 모자 쓰고 와	모자 쓰고 오기	1
밥은 잘 먹고 다녀	밥 잘 먹고 다니기	1
내일부터 백화점 세일인데 쇼핑하러 가자	내일 백화점 쇼핑하러 가기	1
오늘 월급날이지 한턱 쏴	한턱 쏘기	1
여의도에서 인라인스케이트 타자	여의도에서 인라인스케이트 타기	1
까쓰레인지가 꺼졌는지 좀 보고올래	까쓰레인지 꺼졌는지	1
엄마에게 메세지를 보내라	엄마에게 메시지 보내기	1
프로 아마 친선 경기에 관한 기사를 정리해서 보여	프로 아마 친선 경기 관한 기사	1
필리핀 여인과 결혼에 대한 기사를 찾아라	필리핀 여인과 결혼 기사	1
술 한잔 사줄꺼지	술 사주기	1
친구야 언제 돌아오는 거야 빨리 와	빨리 오기	1
경리과에 출장비 지급요청해	경리과에 출장비 지급요청하기	1
이십 키로 짜리 한 통이 필요해	이십 키로짜리 한통 가져오기	1
처음에는 관련 서적을 통해서 주식의 흐름을 익히는 것이 중요합니다	관련 서적 통해 주식의 흐름 익히기	1
지금도 충분히 예쁘니까 다이어트 너무 무리해서 하지마	다이어트 무리해서 하기	0
명동 지점에서 뵙도록 하죠	명동 지점에서 보기	1
이제 그만 자라	자기	1
겨울이 오기 전에 차 정비를 확실히 해	겨울이 오기 전에 차 정비하기	1
물고기 밥 좀 주고 와라	물고기 밥 주기	1
상품 개발이 끊임없이 이뤄져야 해	상품 개발하기	1
규칙적인 식습관을 가지도록 해	규칙적인 식습관 가지기	1
이번 달까지는 분명히 입금해준다고 했는데 왜 소식이 없어  	입금하기	1
이제 그만 헤어져	헤어지기	1
금연하는 게 건강에 훨씬 좋아	금연하기	1
핸드볼 고사 위기에 관한 기사를 찾아줄래	핸드볼 고사 위기 기사	1
대출 받으려면 이자율부터 살펴보도록 해	이자율부터 살펴보기	1
물리 숙제 답 맞춰보자	물리 숙제 답 맞춰보기	1
사무실로 전화주시기 바랍니다	사무실로 전화하기	1
점심 굶고 저녁 회식 뷔페니까 많이 먹어	많이 먹기	1
지윤이 방에 불은 다 꺼졌는지 좀 확인해줄래	지윤이 방 불 다 꺼졌는지	1
졸지말고 운전해	운전하기	2
자기 건강은 스스로 지키는 거야 너도 정기 검진 받아봐	정기검진 받기	1
무리하지 말고 갖고 있는 돈에 맞춰서 투자하세요	갖고 있는 돈에 맞춰서 투자하기	2
오늘 밤부터 태풍이 온다고 하니 일찍들 귀가 하세요	오늘 밤 일찍 귀가하기	1
하루에 세 번은 이빨을 닦아야 충치가 안 생겨	하루 세 번 이빨 닦기	1
괴로워 하지마	괴로워하기	0
음주운전 하지마	음주운전하기	0
일이 그렇게 힘들면 집에 가서 향기요법이라도 써봐	집에 가서 향기요법 써보기	1
널 음향 설정을 영화로 변경해줄래	널 음향 설정을 영화로 변경하기	1
주식은 여윳돈으로 투자하세요	주식은 여윳돈으로 투자하기	1
기다려 주십시오	기다려주기	1
컴퓨터 원격으로 부팅시켜	컴퓨터 원격으로 부팅시키기	1
같이 가보지 않을래	같이 가기	1
이 보다 더 큰 행운은 없을 거야 꼭 축하해줘	축하해 주기	1
꽃샘추위 온다니까 옷 두텁게 입어	옷 두텁게 입기	1
천호대로 소통상황 보여주렴	천호대로 소통상황	1
오르막길에서는 시동이 안 꺼지게 주의해	시동 안 꺼지게 주의하기	1
나 별로 살거 없으므로 끝나고 만나	끝나고 만나기	1
주요 고속도로 현재 교통상황을 알려	주요 고속도로 현재 교통상황	1
스위스 티켓 예매해두자고	스위스 티켓 예매해두기	1
와이티엔 뉴스채널 뉴스의 종류 알려주렴	와이티엔 뉴스채널 뉴스 종류	1
당뇨병의 호전을 원하면 좀더 관리를 철저하게 하는 게 어때 	관리 철저하게 하기	1
내일 물레과목 시험이야 연습해	물레과목 시험 연습하기	1
눈이 피로하면 일양약품을 먹어봐 	일양약품 먹기	1
엘리베이터를 타고 팔층 가십시오	엘리베이터 타고 팔층 가기	1
매일 아침마다 나와 같이 동네 한 바퀴 뛰는 거다	매일 아침마다 같이 동네 한 바퀴 뛰기	1
그 약은 식사하기기 전에 드셔야 합니다	약 식사하기 전에 먹기	1
일주일에 네 번 이상씩 운동하고	일주일에 네 번 이상씩 운동하기	1
춥다 찜질방이나 가자	찜질방 가기	1
빨리 안보내	보내기	1
이번 주 영화 보기로 한 거 예매 좀 부탁해 	이번 주 영화 예매하기	1
이 번 노래 선택해	이 번 노래 선택하기	1
회사 스톡옵션 많이 달라 그래	회사 스톡옵션 많이 달라 하기	1
오르다가도 하루아침에 망할 수 있는게 주식이니까 건전한 사고방식으로 투자를 한다면 한순간에 돈을 날릴 이유도 없어	건전한 사고방식으로 투자하기	1
힘들 때 잠시 나무 그늘에서 쉬다 가	힘들 때 나무 그늘에서 쉬다 가기	1
조교 만나려 하는데 같이 갈래	같이 가기	1
여기서 우회전하셔서 직진하시면 되요	여기서 우회전해서 직진하기	1
여행자 보험 신청해	여행자 보험 신청하기	1
제이엠에스 정명석에 대한 기사를 찾아라	제이엠에스 정명석 기사	1
공부하기 전에 계획부터 세워봐	공부하기 전에 계획부터 세우기	1
사라포바가 나온 기사를 찾아다오	사라포바 나온 기사	1
주차할 때는 주위를 잘 살펴야 돼	주차할 때 주위 잘 살피기	1
우리 졸업전시회 꼭 보러 올 거지 	우리 졸업저시회 보러 오기	1
감기 걸렸다니 오늘 일찍 집에 가서 푹 쉬세요	일찍 집에 가서 쉬기	1
오늘 메일에서 보낸 이가 이순신인 메일 보여주렴	메일 보낸 이가 이순신인 메일	1
연휴 마지막 날의 맑은 날씨를 즐기세요	연휴 마지막 날의 맑은 날씨 즐기기	1
스파게티 공짜 쿠폰 있는데 먹으러 가자	스파게티 먹으러 가기	1
업무 중 외부출타자 꼭 김과장님께 보고 바랍니다	업무 중 외부출타자 김과장님께 보고하기	1
서류들은 종류별로 보관해	서류들 종류별로 보관하기	1
책보다는 증권사와 팍스넷 같은 사이트에서 공부해 봐	증권사와 팍스넷 같은 사이트에서 공부하기	1
그래봐	그러기	0
내일 정인이 재롱잔치야 늦지 말고 와야 해	내일 늦지 말고 오기	1
늦지 않게 빨리 서두르자	서두르기	1
뜨거운 물로 샤워 하고 나오면 몸이 좀 풀릴 거야	뜨거운 물로 샤워하고 나오기	1
페로텍과의 미팅 금요일 오후 한 시로 잡아 주세요	페로텍과의 미팅 금요일 오후 한시로 잡기	1
세탁기 다 돌아갔는지 좀 보여라	세탁기 다 돌아갔는지	1
바이어와 미팅 약속 때문에 술자린 다음으로 미루자	술자린 다음으로 미루기	1
교회의 전국 난립에 대한 기사를 보여라	교회 전국 난립 기사	1
홍가네된장찌개로 바로 와	홍가네된장찌개로 바로 오기	1
모기약 켜 놔 추워서 모기 많이 들어왔겠다	모기약 켜기	1
추가하락에는 분할매수로 대응한다	추가하락에 분할매수로 대응하기	1
선생님께서 점심 시간 끝나고 교무실로 오라고 하셨어	점심 끝나고 교무실 가기	1
무리한 운동은 오히려 안 좋아	무리한 운동하기	0
주말에 시간 있으면 교외로 나가자	주말에 시간 있으면 교외로 나가기	1
그건 좀 위험하니까 신중하게 생각해봐	신중하게 생각하기	1
첫잔은 원 샷 이야 소주잔 털어 확인해	원 샷 소주잔 털어 확인하기	1
병역비리 관련 프로야구 기사 찾아	병역비리 관련 프로야구 기사	1
우리 느끼한 거 먹으러 가자	느끼한 거 먹으러 가기	1
주식투자는 욕심을 부리지 않는 게 중요한 것 같아	주식투자는 욕심부리지 않기	0
다음 월드컵 개최국 관련 기사 찾아다오	다음 월드컵 개최국 관련 기사	1
그래 이번 건 확실하니까 따라와	따라오기	1
이번 주 화요일에 제사 가는거 기록해	이번 주 화요일에 제사 가는거 기록하기	1
스톱옵션 대박을 기대하지 말자	스톡옵션 대박 기대하기	0
제가 있으니 이제 그만 쉬세요	이제 그만 쉬기	1
토요 모임에 많은 참석 바랍니다	토요 모임에 참석하기	1
끊임없이 자기계발을 하도록 해	끊임없이 자기계발하기	1
우리 타임캡슐 만들어요	타임캡슐 만들기	1
잘 해야되	잘 하기	1
늦지 말고 정확히 맞춰서 와야 돼	정확히 맞춰 오기	2
잠깐 뵙고 싶은데 지금 안 될까요 	잠깐 뵙기	1
성격도 비슷한데 앞으로 친하게 지내자	앞으로 친하게 지내기	1
올 겨울 무지 춥다더라 올해는 난로 설치하자	난로 설치하기	1
주식 투자 전략에 관한 잡지를 몽땅 사와라	주식 투자 전략에 관한 잡지 몽땅 사기	1
종합주가지수 좀 보고 나서 이야기 하자	종합주가지수 보고 나서 이야기하기	1
실내 기온이 떨어지면 보일러를 틀어주라	실내 기온이 떨어지면 보일러 틀기	0
로맨틱 코메디 영화 보고 싶어	로맨틱 코메디 영화 보기	1
수요일 점심에 회 먹으러 가자	수요일 점심에 회 먹으러 가기	1
한반도의 위성 사진을 보여줄래	한반도 위성 사진	1
안 바빠 전화통화 할 수 있어	전화통화하기	1
정윤이로부터 온 메일을 스팸 메일로 보내	정윤이로부터 온 메일 스팸메일로 보내기	1
인스턴트 음식 많이 먹지 마라	인스턴트 음식 많이 먹기	0
환기 좀 시켜라	환기하기	1
내가 한거 그대로 쓰면 안돼	내가 한거 그대로 쓰기	0
남산공원 근처 출근길 상황 보여다오	남산공원 근처 출근길 상황	1
시청 로타리 교통 지체 현황은 어떤지 파악하고 싶어	시청 로타리 교통 지체 현황	1
사업을 하려면 제대로 된 계획부터 세워	제대로 된 계획부터 세우기	1
특별 강좌로 취업특강을 한다는데 같이 들으러 가자	취업특강 같이 들으러 가기	1
놀자	놀기	1
수능 보는 날에는 두꺼운 옷보다 얇은 것 겹쳐 입는 것이 좋아	수능 보는 날에는 두꺼운 옷보다 얇은 것 겹쳐 입기	1
지난 학기에 봤던 책 빌려 줄 수 있어 	지난 학기에 봤던 책 빌려주기	1
화요일에 팀 발표 모임하자	화요일에 팀 발표 모임하기	1
뭐 특별히 먹고 싶은 거 있으면 말해 오늘 사줄게	먹고 싶은거 말하기	1
현재 풍랑 경보 현황을 알려줄래	현재 풍랑 경보 현황	1
신갈 쪽이 밀리고 있으니깐 수원 유원지 쪽으로 와	수원 유원지 쪽으로 오기	1
약속 지켰으니까 한턱 쏴	한턱 쏘기	1
내릴 때 뒤에서 오는 오토바이를 조심해야 해 	내릴 때 뒤에서 오는 오토바이 조심하기	1
내일 야참이나 같이 먹죠	내일 야참 같이 먹기	1
과외가 두 시니까 그 전까지는 와야 돼	두 시 전까지 오기	1
아귀찜 좋아하지 신사동에 좋은데 있는데 같이 갈래 	신사동 아귀찜 같이 가기	1
오늘 저녁 약속을 삭제해	오늘 저녁 약속 삭제하기	1
컴퓨터 좀 꺼주겠니	컴퓨터 끄기	1
거실의 쓰레기통 비워와라	거실의 쓰레기통 비우기	1
고기보다는 야채를 많이 먹어	고기보다는 야채 많이 먹기	1
오늘부터 굶기로 했는데 전화해서 자꾸 유혹할래 	전화해서 유혹하기	0
세탁기를 삶음으로 돌려 주겠니	세탁기 삶음으로 돌리기	1
먼저 예약 해 놓고 조금만 기다려	먼저 예약해 놓고 기다리기	1
너 지금 빨리 뉴스 틀어 봐 장세 분위기 장난 아니야	뉴스 틀어보기	1
약속은 반드시 실천하고 책임을 완수하여 신뢰감을 쌓아라	약속 실천하고 책임 완수하여 신뢰감 쌓기	1
엘피지에이 관련 기사 보자	엘피지에이 관련 기사	1
김치 냉장고 오른쪽 칸 숙성 모드로 바꿔주렴	김치 냉장고 오른쪽 칸 숙성 모드로 바꾸기	1
운영위원회에 보고하여 주십시오	운영위원회에 보고하기	1
영어를 배웠으면 외국인하고 한마디 정도는 할 줄 알아야지 	외국인하고 말하기	1
진급 축하한다 한 턱 쏴	한턱 쏘기	1
학생회 회의 있으니 다 모이세요	학생회 회의 모이기	1
인터넷 사용요금에 대한 소식을 찾아라	인터넷 사용요금에 대한 소식	1
너는 종업원들을 좀 더 잘 대할 필요가 있어	종업원들을 좀 더 잘 대하기	1
내방의 현재 모습을 찍어라	내방의 현재 모습 찍기	1
작은방에 텔레비전이 켜져 있는지 확인해주련	작은방 텔레비전 켜져 있는지	1
야 밖에 나올 생각하지 마라	밖에 나오기	0
정확한 계산을 위해서 증권사 영업 창구 직원과 필히 통화해야해	증권사 영업 창구 직원과 통화하기	1
오늘 복날이라는데 삼계탕 사 먹어 	삼계탕 사먹기	1
렉스턴 리콜에 대한 기사를 찾아	렉스턴 리콜 기사	1
버스 맨 뒷자리에 있어 보이면 얼른 타	버스 보이면 타기	1
아이보야 이리로 조금만 다가와라	이리로 조금만 다가오기	1
포인트 제목 있는 이메일을 보여줄래	포인트 제목 있는 이메일	1
올림픽대로 구간의 영상정보를 보여다오	올림픽대로 구간의 영상정보	1
전국의 빨래 지수를 알려줄래	전국 빨래 지수	1
운전자들은 정지선을 무시하시면 안돼요	정지선 무시하기	0
멀티 플렉스 관련 기사를 보여라	멀티 플렉스 관련 기사	1
책 빌리려면 내일 우리 학교로 와	내일 우리 학교로 오기	1
차가지고 야외로 놀러 가자	차가지고 야외로 놀러가기	1
윗몸일으키기 백 개씩 하자	윗몸일으키기 백 개씩 하기	1
늦잠 자서 조금 늦을 텐데 기다려 줘 미안	기다려 주기	1
스테레오 모드 해줄래	스테레오 모드 하기	1
이번 달 이벤트 이메일 전부 보여라	이번 달 이벤트 이메일 전부	1
회비 이만 원 꼭 지참하고 와 주십시오	회비 이만 원 지참하고 오기	1
밖에 비가 오네요 우산 챙기세요	우산 챙기기	1
리오 카니발 여행을 예약해	리오 카니발 여행 예약하기	1
폐업 신고시 해당 관청에 통보해줘야 합니다	폐업 신고시 해당 관청에 통보하기	1
우리집에 올 수 없어	우리집 오기	1
그리스 모린의 방한 일정 관련 기사를 알려	그리스 모린 방한 일정 관련 기사	1
방은 휴식공간 마루는 공부하는 공간으로 쓴다	방은 휴식공간 마루는 공부하는 공간으로 쓰기	1
스키 호주 국제대회에 관한 기사를 찾아줄래	스키 호주 국제대회 기사	1
서울대입구역 이 번 출구 앞에서 네 시에 보자	서울대입구역 이 번 출구 앞에서 네 시에 보기	1
내릴 때 카드 안 찍으면 환승 안 돼	내릴 때 카드 찍기	1
한 일 월드컵에서의 붉은악마들의 활약상에 대한 기사를 보자	한일월드컵에서의 붉은악마들의 활약상 기사	1
중국어 배워 보는 건 어때 	중국어 배우기	1
옆에 차가 지나가도록 니가 먼저 양보해 	양보하기	1
샤워 하면서 몸 좀 풀어	샤워하면서 몸 풀기	1
이치로 선수 홈런에 관한 기사 알려	이치로 선수 홈런 기사	1
자기 스스로 컴퓨터 속의 주식시장을 보며 판단하는 것이 중요해	컴퓨터 속의 주식시장을 보며 판단하기	1
밤새서 피곤 하지 빨리 자	빨리 자기	1
전방에 거의 급커브가 있으니 조심하십시오	전방 급커프 조심하기	1
거기 따뜻해 얇은 옷으로 챙겨 가	얇은 옷으로 챙겨가기	1
이영미 예약을 확인하렴	이영미 예약 확인하기	1
체력검사를 위해 운동장 열 바퀴 뛴다	운동장 열 바퀴 뛰기	1
내일까지는 수선해 주셔야지	내일까지 수선하기	1
다시는 내 뒤통수 치지 마	뒤통수 치기	0
세탁기를 삼십 분 후에 돌려주라	세탁기 삼십분 후에 돌리기 	1
잠깐만요	잠깐 기다리기	1
옷 사줄꺼지	옷 사주기	1
로맨틱 코메디 영화 보고 싶어	로맨틱 코메디 영화보기	1
핸드볼 신생팀에 관한 기사를 모아다오	핸드볼 신생팀 기사	1
회원 접수 마감일이니 서두르십시오	회원 접수하기	1
내가 보낸 메일을 민자가 읽었는지 말해줄래	내가 보낸 메일을 민자가 읽었는지	1
전기 스탠드 좀 켜주라	전기 스탠드 켜주기	1
과일 섭취를 많이 하세요	과일 섭취 많이 하기	1
공부를 하나의 취미로 만드는 건 어때 	공부를 취미로 하기	1
너무 얕게 보지 말고 깊게 좀 봐라	깊게 보기	2
늦게라도 얼굴 비추고 가 못 본지 오래 됐잖아	늦게라도 얼굴 비추고 가기	1
구월 세계 기온 보여	구월 세계 기온	1
내일 연신내역 사번 출구 앞 피자헛 앞에서 세시에 만나죠	내일 연신내역 사번 출구 앞 피자헛 앞에서 세시에 만나기	1
어디로 가면 좋을지 의견을 카페에 각자 올려 주세요	어디로 가면 좋을지 의견을 카페에 올리기	1
공부 잘되 야참 먹으러 가자	야참 먹으러 가기	1
이용 시에는 경범죄로 처벌됩니다	이용하기	0
안 해 안 할거야	하기	1
다음 주 화요일에 회식 있으니까 모두들 시간 비워 두세요	다음 주 화요일에 시간 비워 두기	1
땀이 많이 흐른다 가서 샤워해	가서 샤워하기	1
날씨가 추우니까 보일러 온도를 이십 도로 유지해주련	보일러 온도 이십 도로 유지하기	1
점심 시간 비워 뒀으니까 그때봐	점심 시간에 보기	1
지하철 노선도 보이렴	지하철 노선도	1
강풍으로 해주라	강풍으로 하기	1
너무 날씨가 추울 때는 집에서 쉬세요	너무 날씨가 추울 때는 집에서 쉬기	1
이번 달 쇼핑 이메일 전부 삭제해줄래	이번 달 쇼핑 이메일 전부 삭제하기	1
오늘의 띠별 운세를 찾아라	오늘의 띠별 운세	1
나는 여러분들과 업무를 조화롭게 진행하고 싶습니다	업무 조화롭게 진행하기	1
실권 주를 공략하라	실권주 공략하기	1
해외 진출을 위한 아이디어를 내 주십시오	해외 진출을 위한 아이디어 내기	1
요즘 자외선 지수가 높으니까 모자 쓰고 다녀	모자 쓰고 다니기	1
안전 벨트 메라	안전 벨트 메기	1
이봉주 선수의 아테네 경기 관련 기사 보자	이봉주 선수 아테네 경기 관련 기사	1
현금카드를 가져오셔야 사용 가능합니다	현금카드 가져오기	1
앙코르를 외치면 다시 무대 위로 올라가십시오	앙코르를 외치면 다시 무대 위로 올라가기	1
내 전화번호 바뀐 거 알지 잊지 말고 꼭 저장 부탁해	전화번호 바뀐거 저장하기	2
수능 우리 열심히 공부하자 	수능 열심히 공부하기	1
네가 교육 좀 잘 시켜서 사람 좀 만들어라	교육 잘 시켜서 사람 만들기	1
너가 고객의 입장이 되어 보도록 해	고객의 입장이 되어보기	1
열 바퀴 뛰고 나서 다시 해요	열 바퀴 뛰고 다시하기	1
주차하실 때는 주차요원의 안내를 받으세요	주차할 때 주차요원의 안내 받기	1
오늘 백화점 세일한대 같이 쇼핑 가자	오늘 백화점 쇼핑 가기	1
오늘 도착한 팩스 목록 출력해주겠니	오늘 도착한 팩스 목록 출력하기	1
야 나 오늘 월급탔다 넥스트가자	넥스트 가기	1
외출 후에는 반드시 손을 씻어	외출 후에 손 씻기	1
이번 신정때 날씨 정보를 보여주라	이번 신정 날씨 정보	1
이사회 구성원 명단 위탁서 오늘 내로 작성하세요	이사회 구성원 명단 위탁서 오늘 내로 작성하기	1
그렇게 차 뒤에 바짝 붙어 있으면 위험해	차 뒤에 바짝 붙어 있기	0
다음 교차로에서 우회전 입니다 	다음 교차로에서 우회전하기	1
그날 말고	그날 정하기	0
날씨도 좋은데 교외로 드라이브 가자	교외로 드라이브 가기	1
다른 일이 생겨서 약속을 다음으로 미뤘으면 해요	약속 다음으로 미루기	1
서울 부산 간 지체 구간도 알려주련	서울 부산 간 지체 구간	1
앞으로 댄스 스포츠로 노년의 건강을 챙기세요	건강 챙기기	1
이번 달 쇼핑 이메일을 전부 삭제해줄래	이번 달 쇼핑 이메일 삭제하기	1
만나고 싶으면 먼저 연락해 봐	먼저 연락하기	1
흙탕물 튀니까 흰색 옷은 입지마	흰색 옷 입기	0
한명도 빠짐없이 수업에 참여 하라셔	수업에 참여하기	1
동생에게 메세지를 좀 보내라	동생에게 메시지 보내기	1
보일러 좀 켜줄래	보일러 켜주기	1
무시해	무시하기	1
수익이 났으면 하루쯤 쉬어 보는 게 좋아	하루쯤 쉬기	1
집안의 불 다 켜	집안 불 다 켜기	1
밖에 비가 오네요 우산 챙기세요	우산 챙기기	1
눈도 이렇게 오는데 웬만하면 그냥 택시 타고 와	택시 타고 오기	1
친구야 계좌번호 알려줄 테니 돈은 이리로 부치면 될 거야	돈 계좌로 부치기	1
현관 화면 좀 보자	현관 화면 보이기	1
오늘 컴퓨터용 싸인펜 챙겨와라	오늘 컴퓨터용 사인펜 챙겨오기	1
안방 가서 급탕 스위치 켜주겠니	안방 가서 급탕 스위치 켜기	1
발급요청에 체크하시기 바랍니다	발금요청에 체크하기	1
고속도로에서는 뒷좌석도 안전 벨트를 꼭 매야한다고	뒷자석도 안전벨트 매기	1
침실가서 누나 자는지 확인해	침실 누나 자는지	1
육류보다 채식으로 식생활을 바꿔봐	채식하기	1
수업 끝나고 우리 산책하러 뒷산에 가자	수업 끝나고 뒷산 가기	1
햇빛이 강하니까 쉬면서해	쉬면서 하기	1
내일부터는 같이 운동장 뛰자	내일부터 같이 운동장 뛰기	1
꽤 유명한 맛집라서 손님이 많대 빨리 가자	빨리 가기	1
방은 싱글 예약해	방 싱글 예약하기	1
잠자는 예금 없게 한 은행에서만 거래해	한 은행에서만 거래하기	1
메이저리그 뉴스 보여주렴	메이저리그 뉴스	1
홍사장에게서 온 이메일 있음 알려줄래	홍사장에게서 온 이메일	1
십년 후 이 캡슐을 같이 열어 보는 거야	십년 후 이 캡슐 같이 열어보기	1
내일까지 품평회 차질 없게 준비 잘 하세요	내일까지 품평회 차질 없게 준비하기	1
싸우기 싫으면 가만히 좀 있어	가만히 있기	1
챠트가 불안한 종목은 이익이 났을시 상승 기대 말고 넘기자	차트가 불안한 종목은 이익이 났을 시 상승 기대 말고 넘기기	1
이번 주 우리 회사 이벤트 파티에 와	이번 주 우리회사 이벤트 파티에 오기	1
같이 해볼까	같이 하기	1
아직은 옷 두껍게 입어야 돼	옷 두껍게 입기	1
그 일 혼자 하지 말고 만나서 같이 해	그 일 만나서 같이 하기	2
막히는 도로 위에서는 음악을 들으며 여유를 갖는 게 좋아	음악을 들으며 여유 갖기	1
교통법규는 잘 지켜야 해	교통법규 잘 지키기	1
어깨 축 쳐져서 지내지 마시구요 어깨 쫙 펴세요	어깨 쫙 펴기	2
저리 비켜	저리 비키기	1
울버 햄프턴 구단 관련 소식을 찾아주렴	울버 햄프턴 구단 관련 소식	1
눈이 올 때는 바퀴에 체인을 감고서 다녀	바퀴에 체인 감고 다니기	1
유가 증산 관련 기사를 보여줄래	유가 증산 관련 기사	1
동해 바다로 떠나는 거야	동해 바다로 떠나기	1
오월엔 꼭 같이 나들이 가자	오월에 같이 나들이 가기	1
이천수 소속팀 관련 기사를 보여	이천수 소속팀 관련 기사	1
된장 같은 발효 음식이 건강에 좋대	발효음식 먹기	1
집에 있는 거 다 아니까 빨리 튀어 나와	빨리 튀어 나오기	1
정수기필터 교환 주기를 알려주라	정수기필터 교환 주기	1
전화도 안받는데 만나지마	만나기	0
백화점 세일기간인데 구경 갈까 	백화점 구경가기	1
오랜만에 얼굴 도장 찍자 알았지 	오랜만에 얼굴 도장 찍기	1
샤프심 있으면 빌려줄래 	샤프심 빌려주기	1
작음 음량으로 조절해줄래	작은 음량으로 조절하기	1
포토샵 배울 건데 너도 같이 하자	같이 포토샵 배우기	1
손빈 건 괜찮으세요 약 바르세요	약 바르기	1
덕천교차로 상황을 보고싶다	덕천교차로 상황	1
가스레인지에 불 꺼줄래	가스레인지 불 끄기	1
같이 하면 더 빨리 외울 거야 영어 교재 가지고 와	영어 교재 가지고 오기	1
샤프심 있으면 빌려줄래 	샤프심 빌려주기	1
김선일 참수 관련 기사 찾아라	김선일 참수 관련 기사	1
서울시 전역 도로망 한번 보여주렴	서울시 전역 도로망	1
안방 텔레비전 사 번 돌리렴	안방 텔레비전 사 번 돌리기	1
태풍 온다더라 태풍 대비 잘해	태풍 대비 잘하기	1
국내 바이오 단지와 관련된 사회면 기사 모아줄래	국내 바이오 단지 관련 사회면 기사	1
오늘 발표 네 차례니까 준비 확실하게 해 와야 해	준비 확실하게 하기	1
국내 주가 변동에 관한 기사를 검색해	국내 주가 변동 기사	1
우리 간만에 문구 쇼핑 해	문구 쇼핑하기	1
욕 나오게 하지마	욕나오게 하기	0
실제로 하는 게 좋지 않을까 	실제로 하기	1
엔비에이 최다 득점왕 기사 검색해다오	엔비에이 최다 득점왕 기사	1
너 네 아파트 정문에서 십 분 뒤에 보자	아파트 정문에서 십분 뒤에 보기	1
약속은 반드시 실천하고 책임을 완수하여 신뢰감을 쌓아라	약속 실천하고 책임 완수하여 신뢰감 쌓기	1
커피숍에서 기다리고 있을게 끝나는 대로 와	커피숍에 끝나는 대로 오기	1
가장 최근에 온 순서대로 이메일 보여라	가장 최근에 온 순서대로 이메일 보이기	1
우리 답 맞춰보기로 하자	답 맞춰보기	1
박근혜 조카에 대한 기사를 찾아라	박근혜 조카 기사	1
내일 쇼핑할거야 필요한 거 다 적어 놔	내일 쇼핑 필요한 거 다 적어 놓기	1
동계 올림픽 유치와 관련된 기사를 찾아다오	동계 올림픽 유치 관련 기사	1
법규책 좀 복사해 놔 	법규책 복사해 놓기	1
외국인 투자자들의 동향을 살피세요	외국인 투자자 동향 살피기	1
더운데 은행에서 좀 기다려	은행에서 기다리기	1
여유자금이 있을 때만 주식을 해	여유자금 있을 때만 주식하기	1
홍성균 멘토와 함께 엠티 갑시다	홍성균 멘토와 함께 엠티 가기	1
이번 주말에 동대문 가서 쇼핑하자	이번 주말 동대문 가서 쇼핑하기	1
총 학생회장 선거에서 당선되었다고 하던데 한턱 쏴라	한턱 쏘기	1
주가 상승과 은행금리에 관한 보고서를 제출하세요	주가 상승과 은행금리에 관한 보고서 제출하기	1
학교에 짐 정리 하러 가자	학교에 짐 정리 하러 가기	1
이번 달에 부산에서 있었던 일정을 확인하렴	이번 달 부산에서 있었던 일정	1
다음 주 수업시간에 컴퓨터와 빔프로젝트를 준비하세요	다음 주 수업시간 컴퓨터와 빔프로젝트 준비하기	1
고속도로 정체에 대한 소식 들어온 거 알려	고속도로 정체에 대한 소식	1
거래량의 추이를 확인합니다	거래량의 추이 확인하기	1
테니스 경기에 관련된 기사 찾아	테니스 경기 관련 기사 찾기	1
직접 뵙고 인사드리고 싶습니다	직접 보고 인사하기	1
자전거 타고 누가 더 빨리 가나 내기 해볼래 	자전거 내기하기	1
어젯밤 새 메일 중 아이디 토니가 보낸 이메일을 찾아줄래	어젯밤 새 메일 중 아이디 토니가 보낸 이메일	1
내일 시험 결과 나와 응원해 줄 거지	응원하기	1
수요일은 힘들 것 같고 다음 주 월요일에 만나기로 하자	다음 주 월요일에 만나기	2
거실불 꺼	거실불 끄기	1
저 대신 이번 대회 열심히 뛰세요	저 대신 이번 대회 열심히 뛰기	1
월요일 오후 한 시에 보강 있으니까 꼭 와	월요일 오후 한 시에 오기	1
다음 주 수요일에 음악회 가지 않을래 	다음 주 수요일 음악회 가기	1
너 오늘 보너스 받는 날이지 무조건 한턱 쏴요	한턱 쏘기	1
부모님과 따로 있을 경우 자주 안부를 여쭈어야 도리이다	자주 부모님 안부 여쭙기	1
그 영화 티켓은 네가 예매해줄래 	그 영화 티켓 예매하기	1
급한 일이 있을 수도 있으니 그냥 자유 예금 해	자유 예금 하기	1
헬스도 근육 보강제를 먹으면서 하면 훨씬 좋아	근육 보강제 먹기	1
익지 않은 음식을 드시면 위험 합니다	익지 않은 음식 먹기	0
그 때 약속했던 그 자리에서 기다릴게	그때 약속했던 그 자리에서 보기	1
컴퓨터 하는 사람들 이제 그만 나가래	나가기	1
날씨가 좋으니 외출하세요	외출하기	1
작은방에 불 좀 켜	작은방 불 켜기	1
상장주식 회전율 비율을 분석해 와라	상장주식 회전율 비율 분석해 오기	1
인수인계 오늘까지 부탁합니다	오늘까지 인수인계 하기	1
무지 춥다 장갑 끼고 목도리하고 나와	장갑 끼고 목도리하고 나오기	1
저녁 약속시간 수정해	저녁 약속시간 수정하기	1
오늘 너랑 나랑 청소당번이야 꼭 같이 해	오늘 청소당번 같이 하기	1
정기적으로 혈당 및 요당 검사를 받아 보는 건 어떨까	정기적으로 혈당 및 요당 검사 받기	1
한분도 빠짐없이 맛있게 식사하시고 저 좀 봬요	식사하고 보기	1
차가지고 야외로 놀러 가자	차가지고 야외로 놀러 가기	1
라식 수술 후 컴퓨터 앞에 너무 오래 앉아 있지 마세요	라식 수술 후 컴퓨터 앞에 오래 앉아 있기	0
목동교는 현재 서행구간인지 파악해	목동교 현재 서행구간 여부	1
어제 너 입은 옷 예쁘더라 나 빌려 줄 수 있어	어제 입은 옷 빌려주기	1
사업계획서를 좀 참고하고 싶은데	사업계획서 보이기	1
작은방 불 켜주련	작은방 불 켜기	1
소이 방에 가서 알람 울려주련	소이 방에 가서 알람 울리기	1
오늘 바다의 날씨를 보여줄래	오늘 바다의 날씨	1
강남역 삼번출구에서 보자	강남역 삼번출구에서 보기	1
사장님하고 의논해서 지영씨 카운터에 있게 하기로 했어요	카운터에 있기	1
장마철에는 특히 음식 조심해야 돼요	음식 조심하기	1
술집 예약해 뒀으니까 내일 여덟 시까지 상인 네거리로 와	내일 여덟 시까지 상인 네거리로 오기	1
주식점유율이 좀 더 높여서 의결권을 높입시다	주식점유율 좀 더 높이기	1
부산에 호우 주의보래 다음 주에 가자	부산 다음 주에 가기	1
아직은 가을이 좀 남았나봐 어서 가을 구경 하고 와	가을 구경 하고 오기	1
거짓말 하지마	거짓말하기	0
학교 앞 횡단보도에서는 일단정지를 해야 합니다	학교 앞 횡단보도에서 일단정지하기	1
여러분들의 많은 후원 부탁드립니다	후원하기	1
여섯 시에 테이블을 예약하고 싶어요	여섯 시에 테이블 예약하기	1
겨울엔 특히 혈압환자는 조심해야 되요	혈압환자는 조심하기	1
서울 롯데호텔에 예약해	서울 롯데호텔 예약하기	1
축구 관련 기사 중에 지단에 관련된 것만 보여	축구 관련 기사 중 지단 관련된 것	1
오늘 밤에 도착 메일 모두 보여줄래	오늘 밤 도착 메일 모두	1
배터리를 급속 충전해	배터리 급속 충전하기	1
투자할 때는 항상 최악을 생각하고 투자해 덜 손해봐	항상 최악을 생각하고 투자하기	1
실내 온도를 보여	실내 온도	1
천호대교 북단 교통 흐름 알려주련	천호대교 북단 교통 흐름	1
누나방을 모니터로 보자	누나방 모니터로 보기	1
이영미 이름으로 예약해	이영미 이름으로 예약하기	1
강남역 주변 교통상황을 보고싶어	강남역 주변 교통상황	1
아침공기가 너무 상쾌하다 바람 쐬러 갈래	바람 쐬러 가기	1
정신나이와 육체나이의 균형을 맞춰 보자	정신나이와 육체나이 균형 맞추기	1
그냥 들어가서 죄송하다고만 말씀드려	들어가서 죄송하다고만 말씀드리기	1
레알 마드리드팀 새 감독 관련 기사를 찾아주렴	레알마드리드팀 새 감독 관련 기사	1
뭐 먹고 나면 이빨 깨끗이 닦아	뭐 먹고 나면 이빨 깨끗이 닦기	1
아침에 가야지 김밥 싸가자	김밥 싸가기	1
주식으로 일확천금의 꿈은 갖 지마	주식으로 일확천금의 꿈 갖기	0
요번 달 이벤트 메일 전부 보이렴	요번 달 이벤트 메일 전부	1
투자자는 이익이 나더라도 그 이익을 경계해야해	이익이 나더라도 이익을 경계하기	1
내일 집 앞으로 데리러 갈 테니까 예쁘게 하고 있어	예쁘게 하고 있기	1
오늘 오전에 온 새 편지 찾아줄래	오늘 오전에 온 새 편지	1
법인의 업무와 무관하게 지출하면 안 된다	법인의 업무와 무관하게 지출하기	0
베란다 창문이 열렸는지 보고 와	베란다 창문 열렸는지	1
국민은 보통예금으로 계좌 개설하자	국민은 보통예금으로 계좌 개설하기	1
자동차 쇼 한다던데 보러 갈까 	자동차 쇼 보러 가기	1
독감 주사로 미리미리 예방하세요	독감 주사 맞기	1
차라리 대중교통을 이용하지	대중교통 이용하기	1
그 날 쇼핑하자 핸드백도 사고	그 날 쇼핑하고 핸드백 사기	1
길동이 데리고 와	길동이 데리고 오기	1
지금은 점심시간이야 너도 집에 있다고 밥 거르지 말고 먹어	밥 먹기	2
광고 팀 모델 캐스팅 들어가세요	광고 팀 모델 캐스팅하기	1
경제신문 하나를 구독신청해서 꾸준히 읽어	경제신문 하나를 구독신청해서 꾸준히 읽기	1
이번 가을의 기상 전망을 보여	이번 가을 기상 전망	1
오늘 수업 한곳부터 예습해오세요	오늘 수업한 곳부터 예습해 오기	1
옷 사줄꺼지	옷 사주기	1
내일 수업 준비물 꼭 챙겨와	내일 수업 준비물 챙겨오기	1
오일사번 타고 두 정거장 뒤에 내리면 돼요	오일사번 타고 두 정거장 뒤에 내리기	1
열심히 운동하자	열심히 운동하기	1
여의도 에서 불꽃축제 구경하자	여의도에서 불꽃축제 구경하기	1
연휴 휴유증으로 힘들더라도 기운 내고 일하세요	기운 내고 일하기	1
앞으로 매일 저녁 운동장 뛰자	매일 저녁 운동장 뛰기	1
바쁜데 좀 빨리 안 될까요	빨리 하기	1
삼 주 동안 시험이 없어서 주말엔 좀 놀까 하고 있어 연락 줘	주말에 연락 주기	1
오늘 황사 주의보 떴으니까 마스크 챙겨서 나와	오늘 마스크 챙겨서 나오기	1
내일까지 서류 마무리 짓도록 해	내일까지 서류 마무리 짓기	1
안방 온돌 침대 이 도 낮춰줄래	안방 온돌 침대 이 도 낮추기	1
애들 데리고 동물원 구경 가자	애들 데리고 동물원 구경 가기	1
신촌 현대백화점 앞에 여섯 시까지 모이세요	신촌 현대백화점 앞에 여섯 시까지 모이기	1
미국의 주식시장을 한번 확인해봐	미국의 주식시장	1
오일 평균 이동선 전후로 조정시 매수한다	오일 평균 이동선 전후로 조정시 매수하기	1
오늘의 유머 보여줄래	오늘의 유머	1
인터넷 거래 시 사기에 주의하세요	인터넷 거래 사기 주의하기	1
한번 유학원가서 물어봐	유학원가서 물어보기	1
일곱시에 도착 한다니까 그때까지와	일곱시까지 오기	1
일 주일 사이에 읽지 않은 메일 보여	일주일 사이에 읽지 않은 메일	1
파란 날에 사고 빨간 날에 팝시다	파란 날에 사고 빨간 날에 팔기	1
이번 시험은 파이팅이야 열심히 하자 	이번 시험 열심히 하기	1
귀경길엔 너무 많이 밀리니깐 오늘 저녁에 출발하자	오늘 저녁에 출발하기	1
내일 아홉시 예술회관 정문에서 보는 거다	내일 아홉시 예술회관 정문에서 보기	1
오늘 학교 가기 싫으면 가지 말자	학교 가기	0
사업에 따른 제반 여건을 조사해 봅시다	사업에 따른 제반 여건 조사하기	1
주식은 부동산보다 훨씬 위험해	주식하기	0
밖에 바람이 차가워요 옷 따듯하게 입고 다니세요	옷 따듯하게 입고 다니기	1
무리한 욕심 부리지 말아	무리한 욕심 부리기	0
너무 날씨가 추울 때는 집에서 쉬세요	집에서 쉬기	1
업무와 직접적으로 관련된 것은 반드시 보고를 해야 한다	업무와 직접적으로 관련된 것 보고하기	1
학교에 짐 정리 하러 가자	학교에 짐정리 하러가기	1
주식을 한번도 안 해봤다면 모의 투자를 먼저 해봐	모의 투자를 먼저 해보기	1
교무과로 문의하시겠어요	교무과로 문의하기	1
안마 의자 뒤로 끝까지 눕혀 주겠니	안마 의자 뒤로 끝까지 눕히기	1
조교들은 여섯 시까지 모여	조교들은 여섯 시까지 모이기	1
메이저리그 일정을 찾아라	메이저리그 일정	1
곗돈 모아서 해외여행 가자	곗돈 모아서 해외여행 가기	1
직행 버스로 예약해	직행 버스로 예약하기	1
금리와 원 달러 환율을 고려해 봐	금리와 원 달러 환율 고려하기	1
이번 거래 성공하면 보너스 왕창 줄게	이번 거래 성공하기	1
약은 하루에 두 알씩 먹어라	약은 하루에 두 알씩 먹기	1
계단으로 쭉 올라가면 보일 거야	계단으로 쭉 올라가기	1
오늘 오전 도착 메일 모두 보여줄래	오늘 오전 도착 메일 모두	1
주식에 대한 이해와 이미지가 바뀌어야 합니다 	주식에 대한 이해와 이미지 바꾸기	1
이번 달 쇼핑 이메일을 전부 삭제해줄래	이번 달 쇼핑 이메일 전부 삭제하기	1
효율적인 시간 관리를 하도록 합시다	효율적인 시간 관리하기	1
공부 하러 가자	공부하러 가기	1
슬립 타이머 삼십 분으로 정해	슬립 타이머 삼십 분으로 정하기	1
오늘 많은 비가 예상되오니 안전운전 하세요	안전운전 하기	1
단기보유를 권장 한다	단기보유하기	1
졸업 증명서 필요한데 학교에 같이 좀 가자	학교에 같이 가기	1
두 시간 후에 세탁기 전원을 켜다오	두 시간 후에 세탁기 전원 켜기	1
어제 종합 주가 지수에 대한 기사를 보여라	어제 종합 주가 지수 기사	1
자신의 성격과 주어진 환경에 맞춰 투자 스타일을 잡아야지	성격과 환경에 맞춰 투자 스타일 잡기	1
보유 주식 점검 좀 부탁드릴게요	보유 주식 점검하기	1
설악산의 교통 정보를 알고 싶어	설악산 교통 정보	1
내 휴대전화 이 번호로 바뀌었으니까 다시 저장해	휴대전화 번호 다시 저장하기	1
교회에 가고 있어	교회 가기	1
업무에 따른 유의사항도 전달 해 주도록 해	업무에 따른 유의사항 전달하기	1
예습은 필요 없고 복습이나 열심히 하자	복습하기	2
냉장실 온도 최강으로 해주렴	냉장실 온도 최강으로 하기	1
벌금을 내지 않으신 분은 다음 주까지 내 주시길 바랍니다	벌금 내지 않았으면 다음 주까지 내기	1
조만간 키위쥬스나 먹자꾸나	조만간 키위쥬스 먹기	1
현재 강풍 주의보가 해제된 지역 보여주렴	현재 강풍 주의보 해제 지역	1
오늘 주요 경기에 대해 알리렴	오늘 주요 경기	1
학생회투표가 이틀 남았습니다 많은 참여 바랍니다	학생회투표 참여하기	1
소독 안 하면 병균 들어가	소독하기	1
열쇠 가져가 조금 후 외출해	열쇠 가져가기	1
주식에 투자하려면 뉴스에 귀를 기울여야 돼	뉴스에 귀 기울이기	1
그 영화는 꼭 나랑 보러가기로 약속했었지 	그 영화 나랑 보러가기	1
에스케이 여자 골프에 관한 기사를 찾아줄래	에스케이 여자 골프 기사	1
야 취업 시즌 이다 채용박람회나 가보자	채용박람회 가보기	1
다음에는 미리 약속 정해서 꼭 봐	다음에는 미리 약속 정해서 보기	1
좌석을 예약하고 싶어요	좌석 예약하기	1
본 제품 사용 시 운전이나 보행은 매우 위험합니다	본 제품 사용하며 운전이나 보행하기	0
무역 박람회를 통해 지원서를 받고 있으니 참고하시기 바랍니다	무역 박람회 통해 지원하기	1
문밖을 보게 해주련	문밖 보여주기	1
이번 주 전국 해상의 날씨를 알려라	이번주 전국 해상 날씨	1
대구 공항으로 월요일 아침 여덟 시까지 나오세요	대구 공항 월요일 아침 여덟 시까지 나오기	1
그래도 졸음운전은 위험해	졸음운전하기	0
공부할 때는 뚜렷한 목표를 세워	목표 세우기	1
경기지역 대설에 관한 기사 찾아라	경기지역 대설 관한 기사	1
나중에 쇼핑하러 갈까	나중에 쇼핑 가기	1
기상청 홈페이지에서 주간 예보 꼭 확인해야 해	기상청 홈페이지에서 주간 예보 확인하기	1
도로에서 자전거 타는 것은 너무 위험한 일이야	도로에서 자전거 타기	0
우리나라 양궁의 순위 관련 기사 찾아다오	우리나라 양궁 순위 관련 기사	1
어젯밤 새 메일 중 공지 이메일을 찾아줄래	어젯밤 새 메일 중 공지 이메일	1
오늘 점심 메뉴 정해 오세요	오늘 점심 메뉴 정해 오기	1
포르쉐 컨셉트 카 발표회 관련 기사를 찾아	포르쉐 컨셉트 카 발표회 관련 기사	1
야전침대를 취소해	야전침대 취소하기	1
서울대 앞 우동 전문점 위치를 알려	서울대 앞 우동 전문점 위치	1
그냥 들어가서 죄송하다고만 말씀드려	들어가서 죄송하다고 말씀드리기	1
죄송한데 오늘 과외는 내일로 미루면 안될까요 	오늘 과외 내일로 미루기	1
발표 외에 많은 참석 인원이 필요해	발표 외에 많은 참석 인원 준비하기	1
현금 카드를 분실해서 다시 만들고 싶습니다	현금 카드 다시 만들기	1
보기 싫으면 보지 말자	보기	0
그럼 너는 그거 봐	그거 보기	1
뒷감당도 생각하고 저질러	뒷감당 생각하고 저지르기	1
이리로 와라	이리로 오기	1
아시안 게임 관련 기사 찾아주렴	아시안 게임 관련 기사	1
오늘 저녁약속 있으니 혼자 저녁 먹어	혼자 저녁 먹기	1
싸우기 싫으면 가만히 좀 있어	가만히 있기	1
집에서 혼자 침을 놓으시면 위험 합니다	집에서 혼자 침 놓기	0
너도 휴면계좌 있는지 확인해 봐	휴면계좌 있는지 확인하기	1
할아버지 돌아가셨으니 빨리 조퇴하고 와라	빨리 조퇴하고 오기	1
계획안에 따라 필요한 것을 말씀해 보세요	계획안에 따라 필요한 것 말하기	1
운전 중 휴대 전화 사용도 금지다	운전 중 휴대 전화 사용하기	0
뜨거운 햇볕이 내리 쬐는 날 일사병 조심하세요	일사병 조심하기	1
비 오는 날에는 예쁜 장미를 사	예쁜 장미 사기	1
주식투자 하기 전에는 욕심을 버려	주식투자 하기 전 욕심 버리기	1
라이딩이나 같이 뛸까나	라이딩 같이 뛰기	1
몸보신 좀 해라 많이 여윈 거 같아	몸보신하기	1
오늘 한번 찐하게 놀까	오늘 찐하게 놀기	1
아이로비야 엄마 어깨 좀 주물러	엄마 어깨 주무르기	1
장기적인 성장성이 유지되고 있는 종목으로 선택해	장기적인 성장성이 유지되고 있는 종목으로 선택하기	1
방금 택배 보냈으니까 내일 쯤 갈 거야 받으면 연락해	택배 받으면 연락하기	1
잔소리 하지마	잔소리하기	0
너 차에 헤드라이트 켜져 있던데 빨리 나와서 꺼	차에 헤드라이트 끄기	1
대기업 올 채용과 관련된 기사를 알리렴	대기업 올 채용 관련 기사	1
학생들의 퍼머 및 염색을 일체 금지 합니다	퍼머 및 염색하기	0
여름이 됐으니 어서 바다로 놀러가자	바다로 놀러가기	1
금연 금주 하지마	금연 금주하기	0
아무데나 가자	아무데나 가기	1
너희 먼저가라 뒤따라 갈게	먼저 가기	1
등록금 영수증은 잘 챙겨 둬	등록금 영수증 잘 챙기기	1
로봇 거실로 가라	거실로 가기	1
귀 아픈 거 참지 말고 빨리 병원 가	빨리 병원 가기	2
날씨 쨍쨍한데 이불이나 말려라	이불 말리기	1
이런 진짜 유학가기 전에 한번 만나야 되는데	유학가기 전에 한번 만나기	1
외출 후에는 반드시 손을 씻어	외출 후에 손 씻기	1
안방 보여라	안방 보이기	1
얕은 정보로 섣불리 투자하면 리스크가 커집니다	얕은 정보로 투자하기	0
시계랑 전신거울 합쳐서 만원에 해주세요	시계랑 전신거울 합쳐서 만원에 주기	1
작은방에 선풍기 켜져있는지 확인해	작은방에 선풍기 켜져있는지	1
선생님이 교무실로 오라던데	교무실로 가기	1
유월에서 팔월까지는 샤워실의 온수를 십 팔 도로 고정시켜주라	유월에서 팔월까지 샤워실 온수 십팔도로 고정하기	1
앞 차와 일정 간격을 유지하고 달려	앞 차와 일정 간격 유지하고 달리기	1
실기실 앞에서 보자 	실기실 앞에서 보기	1
날씨가 꽤 추우니 옷 좀 두툼하게 입고 나와	옷 두툼하게 입고 나오기	1
회복을 하시려면 재활치료 꼭 받으셔야 합니다	재활치료 받기	1
기차표를 우선 예매해 두는 게 좋을 거야	기차표 우선 예매하기	1
나 비 올지 모르고 우산 안 가져 왔는데 같이 쓰고 가면 안될까 	우산 같이 쓰고 가기	1
신촌로터리에 바로 좌회전 할 수가 없어서 더 위로 올라갔다가 유턴 해야 돼	신촌로터리 더 위로 올라갔다가 유턴하기	1
네가 쏴 박 상무는 늘 안 쏴	한 턱 쏘기	1
테니스 배우고 싶으면 나한테 와라	나한테 오기	1
스테레오 모드로 해주겠니	스테레오 모드로 하기	1
버스 타고 가고 있으니까 정류장에 마중 나와	정류장에 마중 나오기	1
야간 기차를 예약하렴	야간 기차 예약하기	1
이번 계약 취소로 위약금을 지급해 주시기 바랍니다	위약금 지급하기	1
현재 고속도로 최대 정체구간을 알고싶어	현재 고속도로 최대 정체구간	1
다리 삐면 정형외과 가야지	정형외과 가기	1
오늘 너무 일찍 도착했어 책 읽고 있을테니 얼릉 와	얼릉 오기	1
오늘은 제가 출장을 가므로 뒷일을 부탁합니다	오늘 제 뒷일 해주기	1
심권호 선수 관련 기사 찾아주렴	심권호 선수 관련 기사	1
이번 주 토요일 날 예쁘게 하고 와 	이번 주 토요일 날 예쁘게 하고 오기	1
동계 체전에 관한 기사를 찾아줄래	동계 체전 관한 기사	1
안전거리를 확보하고 운전하도록 합시다	안전거리 확보하고 운전하기	1
세탁기 물 사십 오 도로 설정해 주겠니	세탁기 물 사십 오 도로 설정하기	1
창업 성공사례만 보지 말고 실패사례도 좀 읽어봐	창업 실패사례도 읽어보기	2
투자가 신중해야 해	투자 신중하게 하기	1
제휴카드를 신분증과 함께 보여주세요	제휴카드를 신분증과 함께 보여주기	1
과장님 서류에 결재 좀 해주세요	서류에 결재하기	1
너무 빠지지 말고 적당히 해 	적당히 하기	2
저희의 사랑의 결실을 축하해 주세요	저희의 사랑의 결실 축하해 주기	1
집 안에 뭐가 있는지 확인해	집 안에 있는 것	1
옷장 안 물건 리스트 만들어	옷장 안 물건 리스트 만들기	1
믿어 줘 정말이야	믿어 주기	1
홍은동 녹번역 구간의 교통상황은 어떤지 알려다오	홍은동 녹번역 구간 교통상황	1
국내 야구 화보 보여라	국내 야구 화보	1
몸도 생각해야지	몸 생각하기	1
서울에서 인천가는 국도 지금 막혔는지 알려주렴	서울에서 인천가는 국도 지금 막혔는지	1
차 뒤에 그렇게 바짝 붙어 있는 건 위험 천만한 행동이야	차 뒤에 바짝 붙어 있기	0
아시안 게임에 관한 기사 모두 모아라	아시안 게임 기사	1
추석연휴 중에 하루만 근무하실 수 있는 분 신청 바랍니다	추석연휴 중에 하루만 근무하실 수 있으면 신청하기	1
그래도 졸음운전은 위험해	졸음운전하기	0
눈이 올 때는 바퀴에 체인을 감고서 다녀	바퀴에 체인 감고 다니기	1
집에 도착하면 전화해	집에 도착하면 전화하기	1
비디오폰 연결해서 밖에 누가 왔나 보여	비디오폰 연결해서 밖에 누가 왔나 보이기	1
고객 서비스에도 신경 쓰세요	고객 서비스에도 신경쓰기	1
퇴원하시려면 일주일은 기다리셔야 되겠습니다	일주일 기다리기	1
다른 사람 앞에서는 예의 바르게 행동하기로 약속해요	다른 사람 앞에서 예의 바르게 행동하기	1
과장님 화나셨어 빨리 와	빨리 오기	1
통근버스 시간대 좀 알아놔	통근버스 시간대	1
결석했으면 결석사유서를 가지고 가면 돼	결석사유서 가지고 가기	1
아파트 입구까지 나와 기다릴게	아파트 입구까지 나오기	1
스키장비를 튜닝 받고 싶습니다	스키장비 튜닝하기	1
한국 일보 한자란을 검색해	한국 일보 한자란	1
오늘 밤에 저랑 한 잔 하실래요	오늘 밤 한잔 하기	1
복사본 좀 잘 보관해 두세요 나중에 필요할 거예요	복사본 잘 보관해 두기	1
아침 기온이 뚝 떨어졌으니 따뜻하게 입고 나와	따뜻하게 입고 나오기	1
어젯밤 새 메일 중 공지 이메일 찾아라	어젯밤 새 메일 중 공지 이메일	1
동아 대학교에서 온 이메일을 찾아줄래	동아 대학교에서 온 이메일	1
악착같이 모으려면 현금카드 같은 것 만들지 마	현금카드 만들기	0
관계없는 사람까지 끌어 들이지 마	관계없는 사람 끌어들이기	0
우유가 몸에 좋으니까 많이 먹어	우유 많이 먹기	1
우선 계약금부터 송금하신 후에 연락 주십시오	게약금부터 송금한 후에 연락 주기	1
일본로 축구 응원 가자 	일본으로 축구 응원 가기	1
컴퓨터가 자주 다운되니 조심 하세요 	컴퓨터 다운 조심하기	1
호법 분기점 교통 흐름을 보여	호법 분기점 교통 흐름	1
베란다 조명을 꺼	베란다 조명 끄기	1
시내 쪽은 막히니까 뒷길로 돌아가자	뒷길로 돌아가기	1
불규칙한 식사는 위에 안 좋아	불규칙한 식사하기	0
너도 통합 카드 하나 만들어 	통합 카드 만들기	1
십일월 삼일에 동물원 가자	십일월 삼일 동물원 가기	1
타이거 우즈 경기 기사가 있는지 알려다오	타이어 우즈 경기 기사 여부	1
미납요금 납부바랍니다	미납요금 납부하기	1
미안하지만 뒷정리 좀 부탁합니다	뒷정리하기	1
비디오 반납일이 지났군요 빨리 반납해 주시기 바랍니다	비디오 반납하기	1
십 분 뒤면 은행 문 닫는다고 하니 빨리와	빨리 오기	1
그래도 패러글라이딩은 좀 위험할 거 같은데 꼭 해야겠어 	패러글라이딩하기	0
잠시 쉬면서 다음의 업무를 생각하는 것으로 하자고	잠시 쉬면서 다음의 업무 생각하기	1
현재 피파 랭킹 관련 기사 찾아	현재 피파 랭킹 관련 기사	1
지방대 미달사태에 대한 기사를 보여라	지방대 미달사태 기사	1
빨리 연락해	빨리 연락하기	1
대기업 올 채용 관련 기사를 알려주련	대기업 올 채용 관련 기사	1
그냥 쓰고 돈 생기면 그때 해	돈 생기면 하기	1
내가 정류장으로 마중을 나갈 거니까 버스에 탈 때 문자 보내	버스에 탈 때 문자 보내기	1
어머니 생신 날짜를 좀 알려줄래	어머니 생신 날짜	1
화초가 시들었는지 확인해	화초 시들었는지	1
더워도 배는 꼭 덮고 자	배 꼭 덮고 자기	1
예술의전당 앞으로 한 시까지 와	예술의전당 앞으로 한시까지 오기	1
라디오 팔십 팔 점 구에다가 맞춰	라디오 팔십팔 점 구에다가 맞추기	1
화장대 위를 찍어와	화장대 위 찍어오기	1
위임장 인감증명서 신분증 등이 필요합니다	위임장 인감증명서 신분증 준비하기	1
안방 가서 아기 침대 보여주렴	안방 가서 아기 침대 보여주기	1
주식 투자의 위험이 두렵다면 모의 투자를 한 번 해봐	모의 투자 한번 해보기	1
삼십분 뒤에 일층에서 보자	삼십분 뒤에 일층에서 보기	1
우리나라 옛 지도의 종류 좀 알려주세요	우리나라 옛 지도 종류	1
너 비 자꾸 맞으면 머리 빠져	비 맞기	0
이제 슬슬 니가 알아서 적금 넣어 둬라	알아서 적금 넣어 두기	1
어서 와 모두 모였어	어서 오기	1
단어장을 만들어서 쉬는 시간을 이용해봐	단어장을 만들어서 쉬는 시간 얘기하기	1
너무 미워하지마	너무 미워하기	0
시월 삼일 골프 모임에 꼭 참석 요망	시월 삼일 골프 모임 참석하기	1
내 방에 저장된 화면을 삭제해	내 방에 저장된 화면 삭제하기	1
햇빛이 강하니까 쉬면서해	쉬면서 하기	1
고객님의 주유 할인 서비스가 만기 되었으니 확인하세요	주유 할인 서비스 확인하기	1
꼭 약 먹어	약먹기	1
웰빙을 하려면 자연식을 위주로 해야지 	자연식 위주로 하기	1
국내 외국 용병 선수들에 관한 기사를 찾아줄래	국내 외국 용병 선수들 기사	1
주식은 종합주가지수는 빠지지만 개별주별로 상승할 때 투자하기 좋아	종합주가지수 빠지지만 개별주별 상승할 때 투자하기	1
너 저기 좀 가	저기 가기	1
집안 카메라 고장 체크해	집안 카메라 고장 여부	1
오늘 야구 경기에 관한 신문기사 검색	오늘 야구 경기 관한 신문기사	1
삐면 한의원에 가서 침을 맞아 봐	한의원 가서 침 맞기	1
군내 구타 및 자살사건에 관련된 소식을 모두 찾아라	군내 구타 및 자살사건 관련 소식	1
철수야 나 누군지 알지 나 결혼한다 토요일에 축해해주라 	토요일에 결혼식 오기	1
좀 더 선선해지면 어디 교외로 놀러 갈까 	좀 더 선선해지면 교외로 놀러가기	1
내일 여의도에 인라인 스케이트 타러 가자	내일 여의도에 인라인 스케이트 타러 가기	1
너 오늘 월급날이지 한턱 쏴	한턱 쏘기	1
현재 호우 주의보가 해제된 지역을 보이렴	호우주의보 해제 지역	1
오늘 환율 좀 가르쳐 주지	오늘 환율	1
내시경 하셔야 되니 음식물 섭취를 금지합니다	음식물 섭취하기	0
최경주 선수 근황에 관련된 기사를 찾아라	최경주 선수 근황 관련 기사	1
오후 아홉시 도착으로 예약해	오후 아홉시 도착으로 예약하기	1
트렁크 열어서 가져가세요	트렁크 열어서 가져가기	1
시청 로타리 교통 상태는 어떤지 파악해주련	시청 로타리 교통 상태	1
컴퓨터는 함부로 강제 종료 하면 안돼	컴퓨터 강제 종료하기	0
서명으로 예금을 찾으실 때는 본인이 직접 오셔야 합니다	본인이 직접 오기	1
거기서 유턴하면 안 된다	유턴하기	0
약 드세요	약 먹기	1
오늘은 도서관 정기휴일이니까 혹시라도 가면 안돼	도서관 가기	0
따뜻하게 챙겨 입어	따뜻하게 챙겨 입기	1
오늘 세시로 레슨시간이 변경 됐으니 늦지 마	오늘 레슨시간 늦기	0
외국어는 어휘력이 중요해 단어 공부를 좀 더 해 봐	단어 공부 더 하기	1
낼은 꼭 교회 올 거지 꼭 기다리고 있을게	낼 교회 오기	1
불국사 가는 길 보여라	불국사 가는 길	1
경비실에 우리집 상황을 알려라	경비실에 우리집 상황 알리기	1
스노보드 꼭 한 번 타봐 후회는 없을 거야	스노보드 타보기	1
아시안 게임 관련 기사 찾아주렴	아시안 게임 관련 기사	1
내일 디즈니랜드 갈 건데 저랑 같이 갈래요	내일 디즈니랜드 같이 가기	1
어제 맡긴 휴대폰 찾아가야지	어제 맡긴 휴대폰 찾아가기	1
간접투자는 대개 뭉칫돈으로 이루어져 위험해	간접투자하기	0
내방의 불을 켜라	내방 불 켜기	1
여기 가만히 서서 아기 방을 찍어	가만히 서서 아기 방 찍기	1
외워외워	외우기	1
너 이번 달 곗돈 은행으로 입금하는 거 알지 	이번 달 곗돈 은행으로 입금하기	1
우리 회사 앞으로 지금 당장 와	우리 회사 앞으로 지금 오기	1
강변도로가 많이 막히고 있는지 보고싶어	강변도로 많이 막히는지	1
혼잡이 예상되오니 질서를 지켜주세요	질서 지키기	1
아버지 승진 기념 외식이니까 저녁 먹지 말고 들어와	저녁 먹지 말고 들어오기	1
더위가 일찍 와서 올 휴가를 좀 미리 가자	올 휴가를 좀 미리 가기	1
확실한 종목 놓치지 마	확실한 종목 놓치기	0
우리 이따가 만나서 같이 시간표 짜자	이따가 만나서 같이 시간표 짜기	1
외국인 투자자들의 움직임을 잘 봐야돼	외국인 투자자들 움직임 잘 보기	1
할머니 혈압 기록 보여주련	할머니 혈압 기록	1
시디 플레이어 일시정지 시켜줄래	시디 플레이어 일시정지하기	1
오늘 오전에 도착한 메일 모두 보이렴	오늘 오전에 도착한 메일 모두	1
논문 초록에 글자체와 띄어쓰기 잘 맞춰서 써	논문 초록 글자체 띄어쓰기 잘 맞춰서 쓰기	1
엘리베이터가 고장 났으니 계단을 이용하세요	계단 이용하기	1
기름이 별로 없으니 주유소에 들리자	주유소에 들리기	1
자세한 건 월요일에 선생님 뵙고 이야기 들어	월요일에 선생님 뵙고 이야기듣기	1
민박 하지 말고 펜션을 잡자고 예쁜 곳 많던데	펜션 잡기	2
수영할 때 발에 쥐가 날수도 있으니 조심하세요	수영할 때 발에 쥐 조심하기	1
응급 환자 수술로 모두 모여 주시기 바랍니다	응급 환자 수술로 모두 모이기	1
독감예방 접종 하러가지 않을래 	독감예방 접종 하러가기	1
주말에 나랑 교외로 드라이브나 가자	주말에 교외로 드라이브 가기	1
빨리 전화 해	전화하기	1
큰 형님 댁으로 전화 연결해 주겠니	큰 형님 댁으로 전화 연결하기	1
보스턴 승리와 관련된 소식 검색	보스턴 승리 관련 소식	1
백 이동 주민 여러분은 아파트 뒤편을 청소해주세요	백이동 주민이면 아파트 뒤편 청소하기	1
운동하고 나서 바로 찬 물로 샤워하면 안 돼	운동하고 나서 바로 찬 물로 샤워하기	0
단대오거리 차량들 흐름은 어떤지 파악해주련	단대오거리 차량들 흐름	1
연락해	연락하기	1
이거랑은 관계없이 끝내	이거랑 관계없이 끝내기	1
모두 자기 작업 위치로 가서 대기하고 계세요	자기 작업 위치로 가서 대기하기	1
전국 강우 집계표를 보이렴	전국 강우 집계표	1
강세 시장에서 뒤늦게 움직이는 주식에 주목해	뒤늦게 움직이는 주식에 주목하기	1
현관에 누군가 오면 좀 알려	현관에 누군가 오면 알리기	1
홍대 케이에프씨 앞에서 보자	홍대 케이에프씨 앞에서 보기	1
일확천금의 꿈을 버려	일확천금의 꿈 버리기	1
올림픽대로에서 가다 서다를 반복하는 구간을 알려다오	올림픽대로 가다서다 반복하는 구간	1
복날이다 나와라 같이 삼계탕이나 먹자	같이 삼계탕 먹기	1
열 시 이전의 저가로 내려가면 매도한다	저가 매도하기	1
수업 끝나고 우리 산책하러 뒷산에 가자	수업 끝나고 산책하러 뒷산 가기	1
정치에 대한 기사를 찾아라	정치에 대한 기사	1
건강 보험 적자에 대한 기사를 찾아	건강 보험 적자 기사	1
수업 필기한 것 있으면 좀 보여줄 수 있어 	수업 필기한 것	1
외부인의 침투가 발견되면 경보를 울려라	외부인 침투 발견되면 경보 울리기	1
그 책 읽고 독후감 써 오래	그 책 읽고 독후감 써 오기	1
리포트 월요일까지 꼭 내주세요	리포트 월요일까지 내기	1
비오니까 집에 있는 빨래 걷어라	집에 있는 빨래 걷기	1
늘 처음 그대로의 마음으로 살자	처음 그대로의 마음으로 살기	1
농구경기 보러 갈래 옛 생각 나고 좋잖아	농구경기 보러 가기	1
우리 스터디 짜서 같이 공부할까 	스터디 짜서 같이 공부하기	1
머리 아프다고 자꾸 약 먹으면 안돼요	머리 아프다고 자꾸 약 먹기	0
헬스 꾸준히 해 근육 좀 키워	헬스 꾸준히 하고 근육 키우기	1
스페인에 진출한 이천수 관련 기사 모아주련	스페인에 진출한 이천수 관련 기사	1
송금을 하기 위해서는 자유입출금식 통장을 개설하는 게 좋아	자유입출금식 통장 개설하기	1
수화물 표를 보여주실래요	수화물 표	1
교통법규는 위반하지 마	교통 법규 위반하기	0
용민이한테 온 이메일만 모아서 검색해줄래	용민이한테 온 이메일만	1
집에 가고 있어	집에 가고 있기	1
오후 여섯시 이후에 온 이메일은 다 쓰레기통으로 보내라	오후 여섯시 이후에 온 이메일 다 쓰레기통으로 보내기	1
계단이 얼었으니 넘어지지 않게 조심이 내려가	계단 넘어지지 않게 조심하기	1
안내방송에 주의를 기울이시고 지시에 따라 주십시오	안내방송에 주의 기울이고 지시에 따르기	1
에어컨을 이십 삼 도로 온도 조절해줄래	에어컨 이십 삼 도로 온도 조절하기	1
영화 티켓 예매해 놨으니까 저녁 먹고 연락해	저녁 먹고 연락하기	1
복날에 삼계탕 먹으러 가자	복날에 삼계탕 먹으러 가기	1
미군 파병 관련 기사를 찾아라	미군 파병 관련 기사 찾기	1
로페즈 은퇴 관련 기사 찾아주렴	로페즈 은퇴 관련 기사	1
서울 수원 간 정체구간을 모두 보고싶어	서울 수원 간 정체구간 모두	1
의약품 사용할 때 의사나 약사랑 상의해	의약품 사용할 때 의사나 약사랑 상의하기	1
시월달 동경 기온을 찾아라	시월달 동경 기온	1
잔소리 하지마	잔소리하기	0
오늘 경마나 하러 과천 가자	경마하러 과천 가기	1
늦지 않게 빨리 서두르자	빨리 서두르기	1
인터넷 쇼핑몰 사업을 시작했으니까 들려서 한번 봐주라	쇼핑몰 봐주기	1
조퇴하기 전에 결재 서류 올려놓고 가	조퇴하기 전에 결재 서류 올려놓고 가기	1
슈퍼에서 할인행사 중인데 안 가볼래	슈퍼 할인행사 가보기	1
간단히 말해 돈 좀 꿔죠	돈 꿔주기	1
오빠 저녁 드시고 오시는 거예요	저녁 먹고 오기	1
팔월달의 일정 중 이십일 일정 모두 삭제해	팔월달의 일정 중 이십일 일정 모두 삭제하기	1
아이로비야 이만 눈감고 쉬어라	쉬기	1
부천 대 삼성 경기에 관한 기사 모아라	부천 대 삼성 경기 관한 기사	1
거실 창문을 열어라	거실 창문 열기	1
외국인 투자자들의 움직임을 잘 봐야돼	외국인 투자자들 움직임 잘 보기	1
아침마다 운동하기로 한 건 왜 안 지키니 	아침마다 운동하기	1
다른 일이 생겨서 약속을 다음으로 미뤘으면 해요	약속 다음으로 미루기	1
세계의 움직임도 파악할 줄 알아야 해	세계의 움직임 파악하기	1
수영을 해 봐	수영하기	1
기타 연습하러 가자 매번 빠졌잖아	기타 연습하러 가기	1
아디다스에서 츄리닝 사자 세일한대	아디다스에서 츄리닝 사기	1
그 외 결함이 있으시면 문의 해 주시기 바랍니다	그 외 결함이 있으면 문의하기	1
내일 춥데 옷 따뜻하게 입고 나가	옷 따뜻하게 입고 나가기	1
너무 졸려서 그러니 한시간 뒤에 나 좀 깨워줄래 	한시간 뒤 깨워주기	1
아직 해약하지 말고 그냥 둬	그냥 두기	2
여행가기 전에 은행에 가서 환전 해 둬	은행가기 전에 은행 가서 환전해 두기	1
사업 아이템 너무 좋아요 포기하지 마세요	사업 아이템 포기하기	0
봄 내음이 완연한데 같이 사진 찍으러 가자	같이 사진 찍으러 가기	1
눈 치우러 오실 분은 빨리 오세요	눈 치우려면 빨리 오기	1
일요일에 한 번 뵐 수 있을까요	일요일에 보기	1
피로 회복제도 많이 먹으면 중독 된다 	피로회복제 많이 먹기	0
이란 이라크전 관련 기사를 보여라	이란 이라크전 관련 기사	1
혈압이 높으니 마음을 편하게 유지 하도록 하십시오	마음을 편하게 유지하기	1
수원 천안 간 고속도로 상황을 알려다오	수원 천안 간 고속도로 상황	1
주봉 챠트와 거래량으로 상한가 종목을 알아야 해	주봉 챠트와 거래량으로 상한가 종목 알기	1
프로젝트 기획서 의논 차 좀 만났으면 합니다	만나기	1
몇 년 만 견뎌서 경력 쌓자	몇 년 견뎌 경력 쌓기	1
소외된 주식은 거들떠보지도 않는 게 좋아	소외된 주식 거들떠보기	0
너 없는 서울이 너무 썰렁하다 어서 올라와	서울 어서 올라오기	1
날씨도 더운데 삼계탕이나 수박 드세요	삼계탕이나 수박 먹기	1
박찬호의 최근 성적 관련 기사 찾아주렴	박찬호 최근 성적 관련 기사	1
나만 믿어	나만 믿기	1
주유소에서 기름 넣어야 하니까 거기서 봐	주유소에서 보기	1
너 벌금 내고 싶으면 늦게 와	늦게 오기	0
꾸준히 운동을 해야 효과가 있어요	꾸준히 운동하기	1
옷 두껍게 입고 나와	옷 두껍게 입기	1
소렌스탐의 방한에 관한 기사를 찾아줄래	소렌스탐 방한 기사	1
어제 강풍 경보 현황을 알려라	어제 강풍 경보 현황	1
조조 보지 말고 그냥 오후에 영화 보자	오후에 영화 보기	2
챙겨 먹어	챙겨 먹기	1
오늘 새 편지 중 정미가 보낸 메일 찾지	오늘 새 편지 중 정미가 보낸 메일	1
서울행 무궁화호 두 장 예약해	서울행 무궁화호 두 장 예약하기	1
문화방송 앞 도로 상황 좀 보여주렴	문화방송 앞 도로 상황	1
그럼 개강 날 학교에서 보자	개강 날 학교에서 보기	1
오늘 일기도 보여라	오늘 일기도	1
여러 장의 시디 전체 다 듣고 싶단다	여러 장의 시디 전체 다 듣기	1
흡연에 관련된 건강기사를 찾아라	흡연 관련 건강기사	1
모레 새벽 다섯 시 반까지 낙성대역 팔번 출구 앞이다	모레 새벽 다섯 시 반까지 낙성대역 팔번 출구 오기	1
조금만 더 빨리 해줄 수 있어	조금만 더 빨리 해주기	1
아르바이트 근무여건 만족도 설문조사에 응해주세요	아르바이트 근무여건 만족도 설문조사에 응하기	1
전화는 왜 안 받아 목소리 듣고 싶다 	전화 받기	1
만기가 다 됐으면 다시 새로운 적금으로 갈아타	새로운 적금으로 갈아타기	1
추가 하락의 움직임이 나오면 손절매 한다	추가 하락의 움직임이 나오면 손절매하기	1
외로운 솔로들은 모두 모이세요	외로운 솔로 모두 모이기	1
대리 이번에 승진한다며 한턱 쏴	한턱 쏘기	1
나 이번에 곗돈 타면 그 돈으로 사업해 봐	곗돈으로 사업하기	1
약 드세요	약 먹기	1
오는 길에 주유소 들러서 기름 넣어 오세요	오는 길에 주유소 들러서 기름 넣기	1
부엌 뒷베란다 셔텨 올려	셔터 올리기	1
생선에서 암 유발 물질이 나왔다는데 먹지 마	생선 먹기	0
놀이 공원 가고 싶어	놀이공원 가기	1
생선의 머리와 꼬리는 고양이에게 던져주라	생선의 머리와 꼬리는 고양이에게 던져주기	1
진행요원들은 네 시까지 사무실로 모여 주시기 바랍니다	진행요원들 네 시까지 사무실로 모이기	1
에어컨 온도 이십 일 도로 낮춰주련	에어컨 온도 이십 일 도로 낮추기	1
맨날 집에서 뒹굴지 말고 나와	집에서 나오기	2
화장실 불이 꺼졌는지 좀 확인해줄래	화장실 불 꺼졌는지	1
주말에 어디 바람 쐬러 가자	주말에 바람쐬러 가기	1
안돼 아무리 친한 친구라도 보증은 금물이야	보증하기	0
해외 파견 근무를 원하는 사람은 지금 바로 신청하래	해외 파견 근무 원하면 지금 바로 신청하기	1
아르바이트 쓰시는 게 업무에 효율적일 겁니다	아르바이트 쓰기	1
외국인 투자자의 매매 동향으로 시장의 줄기를 잡아라	외국인 투자자 매매 동향으로 시장의 줄기 잡기	1
날씨도 맑고 하늘도 깨끗하고 좋은데 야외로 놀러가자	야외로 놀러가기	1
지금 회사 앞으로 가는 중이야 끝나면 바로 나와	끝나면 바로 나오기	1
아기옷 만들기 동호회 공지 이메일이 왔는지 확인해줄래	아기옷 만들기 동호회 공지 이메일 여부	1
기억하고 있어	기억하고 있기	1
경품 행사를 의뢰할까 하는데요	경품 행사 의뢰하기	1
주식에 빠지는 건 위험해	주식에 빠지기	0
나중에 통화해	나중에 통화하기	1
새벽 시장이 오늘부터 개장되오니 많은 이용바랍니다	새벽 시장 이용하기	1
다음 연휴까지 열심히 일해봅시다	다음 연휴까지 열심히 일하기	1
피부의 수분과 유분 비율을 잘 조절하는 게 중요해	피부의 수분 유분 비율 잘 조절하기	1
점심 먹은 후에 운동장에서 하루에 다섯 바퀴 씩 뛰자	점심 먹은 후 운동장 하루에 다섯바퀴씩 뛰기	1
기타 연습하러 가자 매번 빠졌잖아	기타 연습하러 가기	1
세탁물 십 오 분 간 탈수시켜주라	세탁물 십 오 분 간 탈수시키기	1
상일 인터체인지에서 대전 인터체인지까지 까쓰충전소가 있는 휴게소는 몇 군데인지 알려주렴	상일 인터체인지에서 대전 인터체인지까지 까쓰충전소 있는 휴게소 수	1
내일 워크샵 회비 준비 해 주세요	내일 워크샵 회비 준비하기	1
차범근에 대한 기사를 보여다오	차범근에 대한 기사	1
지금 이 방 온도가 몇 도인지 알려주겠니	지금 이방 온도	1
은행 수수료는 빼고 입금합니다	은행 수수료 빼고 입금하기	1
이번 여름 방학 때 유럽으로 배낭여행 가자	이번 여름 방학 때 유럽으로 배낭여행 가기	1
월남 파병 관련기사 찾아라	월남 파병 관련기사	1
튜브의 공기는 이걸로 넣으세요	튜브의 공기 이걸로 넣기	1
보고 싶은 영화 있으면 저랑 같이 보러 가요	보고 싶은 영화 있으면 같이 보러 가기	1
우리 그럼 몇 년 뒤에 만나는 거야	몇 년 뒤에 만나기	1
부산 해운대 조선비치호텔 예약을 해줄래	부산 해운대 조선비치호텔 예약하기	1
먼저 처리해야 할 일이 무엇인가를 확인하여 추진하도록 해	처리해야 할 일 확인하며 추진하기	1
까쓰렌지 켜져 있으면 꺼	까쓰렌지 끄기	1
행사 끝나고 뒤풀이 있는 거 아시죠 회비 없으니까 꼭 오세요	행사 끝나고 뒤풀이 오기	1
컴퓨터 절전모드로 해다오	컴퓨터 절전모드 하기	1
라디오 팔십 팔 점 구에다가 맞춰	라디오 팔십팔 점 구에 맞추기	1
이번 주 토요일 직원 모두 워크숍 참석하세요	이번 주 토요일 워크숍 참석하기	1
내가 예상보다 빨리 도착했으니 서둘러 주세요	서두르기	1
턴테이블 정지해주련	턴테이블 정지하기	1
상속세 관련 기사 찾아라	상속세 관련 기사	1
현재 풍랑 주의보 해제 지역을 보이렴	현재 풍랑 주의보 해제 지역	1
괜히 속도위반 하지마	속도위반하기	0
웬만하면 금으로 하지 말고 아멜감으로 때워라	아멜감으로 때우기	2
집에 있어봐 쉬는 시간에 전화할게	집에 있기	1
스노보드 탈 때는 보호대가 필수야	보호대 하기	1
이번 결혼식 끝나면 우리끼리 뒤풀이 하니까 시간 비워둬	이번 결혼식 끝나고 시간 비워두기	1
비행기 예약 하렴	비행기 예약하기	1
햇빛이 따가운 오늘 같은 날은 썬 크림을 발라야 해	썬크림 바르기	1
매주 만 원씩 꼭 곗돈 부어	매주 만원씩 곗돈 붓기	1
롯데리아 앞에서 한 시간 뒤에 보자	롯데리아 앞에서 한 시간 뒤에 보기	1
중간쯤에서 만나는 게 가장 빠르겠다	중간쯤에서 만나기	1
동생 귀국하는 날이야 퇴근하고 바로 와	퇴근하고 바로 오기	1
곧 추석이라 기차나 버스표 빨리 예매해야 할 거야	기차나 버스표 빨리 예매하기	1
미안해 나 오늘 점심약속 있어 너 먼저 먹어	점심 먼저 먹기	1
입시 정책 관련 기사를 찾아라	입시 정책 관련 기사	1
냉장고 안에 있는 냉동만두 튀겨 먹자	냉장고 안에 있는 냉동만두 튀겨 먹기	1
빈집털이가 유행하고 있으니 문단속을 잘 해주십시오	문단속 잘 하기	1
김포공항 진입로 보여라	김포공항 진입로	1
늦지않게 참석해 주십시오	늦지않게 참석하기	1
전화는 사전 해지해	전화 사전 해지하기	1
예전 그 약속 꼭 지켜주길 바래	그 약속 지키기	1
위 사항을 명시할 것을 제차 알려드립니다	위 사항 명시하기	1
먼저 네 자신의 투자성향을 파악해	투자성향 파악하기	1
전기 스위치를 모두 확인하고 와	전기스위치 모두 확인하기	1
무조건 안 먹으면 나중에 요요로 더 고생한다니까	무조건 먹기	1
잔소리 그만해 귀 따가워	잔소리하기	0
안방 가서 이비에스 켤래	안방 가서 이비에스 켜기	1
우리나라의 예술적 가치와 우수성을 세계에 널리 알립시다	우리나라의 예술적 가치와 우수성을 세계에 널리 알리기	1
우리 싸워도 각방 쓰지 말자	싸우고 각방 쓰기	0
파크 호텔이요	파크 호텔 가기	1
통근버스 시간을 찾아놔	통근버스 시간	1
최근 도착한 날짜부터 메일을 보여주렴	최근 도착한 날짜부터 메일 보여주기	1
주식시장 동향 파악바랍니다	주식시장 동향 파악하기	1
그만 쉬어라	쉬기	1
시청 로타리 차량 통행 상황을 보여주렴	시청 로타리 차량 통행 상황	1
오후 아홉시 도착으로 예약해	오후 아홉시 도착으로 예약하기	1
약속하면 꼭 늦게 오더라 네가 밥 쏴	밥 쏘기	1
환율 바뀔수록 투자대상 바꿔 	환율 바뀔수록 투자대상 바꾸기	1
그 영화 보지마	그 영화 보기	0
피곤하면 바깥 바람이나 쐬러 가자	바깥 바람 쐬러 가기	1
공부만이 살 길이야 열심히 해	공부 열심히 하기	1
티브이를 삼십 분 있다가 켜라	티브이 삼십분 있다가 켜기	1
통장을 가져오셔야 합니다	통장 가져오기	1
연휴 동안 맛있는 음식 많이 먹고 오렴	연휴 동안 맛있는 음식 많이 먹기	1
여유 돈 있으면 우리 회사 주식에 투자해	우리 회사 주식에 투자하기	1
회의 끝나고 커피나 한잔 하게 휴게실로 와	회의 끝나고 휴게실로 오기	1
창문 옆 좌석을 주셨으면 합니다	창문 옆 좌석 주기	1
식탁 위에 곰국 있으니까 그걸로 아침 먹어라	식탁 위 곰국 먹기	1
고사장 입실 시 유의사항을 필독하세요	고사장 입실 시 유의사항 필독하기	1
무리한 운동은 오히려 안 좋아요	무리한 운동하기	0
회의시간에 맞춰 참석하여 주시기 바랍니다	회의시간 맞춰 참석하기	1
최근 창단된 여자 농구팀 관련 소식 알려주렴	최근 창단된 여자 농구팀 관련 소식	1
서해안 고속도로 구간의 흐름을 알려주련	서해안 고속도로 구간 흐름	1
내일 소개팅 있는 거 알지 예쁘게 하고 나와	내일 소개팅 예쁘게 하고 나오기	1
기차표 예약 해	기차표 예약하기	1
도로의 구간별 소요 시간을 알려라	도로의 구간별 소요 시간	1
최부장님에게 이메일을 쓰자	최부장님에게 이메일 쓰기	1
대문 앞에 택배가 왔는지 확인해	대문 앞 택배 왔는지	1
해약 하려면 그 은행 삼층에 가야해	해약하려면 그 은행 삼층 가기	1
농구 대잔치에 관한 기사 찾아볼래	농구 대잔치 기사	1
추석특집 영화 관련소식 보여라	추석특집 영화 관련소식	1
스승의 날에 선생님께 안부전화 드리자	스승의 날에 선생님께 안부전화 드리기	1
백화점 내에서 쇼핑하실 때는 소지품에 주의하세요	쇼핑할 때 소지품 주의하기	1
요즘 고민이 많아 만나서 얘기하자	만나서 얘기하기	1
오늘 점심 때 로비에서 십분 일찍 봐요	점심 때 로비에서 십분 일찍 보기	1
오늘 도착한 팩스 목록 출력해줄래	오늘 도착한 팩스 목록 출력하기	1
샤워 하고 바로 나갈 테니 기다려	기다리기	1
춥다고 움츠리고 있지만 말고 가슴 쫙 펴고 힘차게	가슴 쫙펴기	2
간만에 만나는 거니까 예쁘게 하고 와	예쁘게 하고 오기	1
태영프라자에서 컴퓨터 무료 강의 해주던데 한번 가봐	태영프라자 컴퓨터 무료 강의 가보기	1
시간을 좀 늦췄으면 좋겠는데 어떠니 	시간 좀 늦추기	1
까쓰레인지 한 시간 있다가 켜라	까쓰레인지 한 시간 있다가 켜기	1
내일 전국의 밀물 썰물 시간을 알려라	내일 전국의 밀물 썰물 시간	1
소이 방 천정 보자	소이 방 천정	1
삼성차 리콜 관련 기사 찾아라	삼성차 리콜 관련 기사	1
나 지금 유원지니까 앞에 나와서 서있어	앞에 나와서 서있기	1
군내 구타 및 자살사건 관련된 소식을 모두 찾아라	군내 구타 및 자살관련 소식	1
신용카드 번호 외우고 있어	신용카드 번호 외우기	1
실록이 우거지는 유월이 시작됐어 웃으며 시작하자	웃으며 시작하기	1
전기 스탠드 좀 켜주라	전기 스탠드 켜기	1
너무 위험하게 투자하는 거 아냐	위험하게 투자하기	0
티비 채널을 사십 삼 번으로 돌려라	티비 채널을 사십 삼 번으로 돌리기	1
에어컨을 켜라	에어컨 켜기	1
대문을 잠궈줄래	대문 잠그기	1
태풍 오니까 밖에 나가지 마	밖에 나가기	0
자신 외에는 아무도 믿지 말고	자신 외에는 아무도 믿지 말기	0
여름에는 바닷가에서 해수욕이나 하자	바닷가에서 해수욕하기	1
내가 선물한 거 꼭 집에 가서 풀어야봐야 해	집에 가서 선물 풀기	1
영화나 같이 보자 내가 예매 해 놓을게	영화 같이 보기	1
오후에 종로 쪽으로 외근 나가니까 잠깐 봅시다	오후에 종로 쪽 잠깐 보기	1
현관문 열어주라	현관문 열어주기	1
웬만하면 약 먹지 말고 버텨 봐	버텨 보기	2
경부 고속도로의 교통상황을 말해주라	경부 고속도로 교통상황	1
대통령기 요트 대회 소식을 뽑아주렴	대통령기 요트 대회 소식 뽑기	1
내가 아는 한의원 원장님 침 잘 놓는데 같이 가자	내가 아는 한의원 가기	1
그 은행이 금리가 낮더라 바꾸어서 맡겨라	은행 바꾸어서 맡기기	1
부장님 결재 서류 오늘까지 검토 해주셔야 하는데요	결재 서류 오늘까지 검토하기	1
주식으로 돈을 벌려면 욕심을 버리도록 하세요	욕심 버리기	1
나는 교회보다는 학교에서 만나고 싶어	학교에서 만나기	1
겨울이 오기 전에 차 정비를 확실히 해	겨울이 오기 전에 차 정비하기	1
조정 때 미리 사 두는 게 괜찮아	조정 때 미리 사 두기	1
세탁기 잘 돌아가는지 알려라	세탁기 잘 돌아가는지	1
현재 한국 프로야구 순위 현황 보여주렴	현재 한국 프로야구 순위 현황	1
전시회는 따분해서 싫은데 영화 봐요	영화 보기	2
더운데 더위 먹지말고 집에 일찍 들어가	집에 일찍 들어가기	2
수유역 사번 출구로 나오셔서 마을버스를 타고 오세요	수유역 사번 출구로 나와 마을버스 타기	1
세탁 다 되면 세탁기 뚜껑 좀 열어줄래	세탁 다 되면 세탁기 뚜껑 열어주기	1
할아버지 돌아가셨으니 빨리 조퇴하고 와라	빨리 조퇴하고 오기	1
인터넷 금융 사기의 유형들을 연구하자	인터넷 금융 사기의 유형들 연구하기	1
서울 시내 정체구간을 보여다오	서울 시내 정체구간	1
특별한 일 없으면 오늘 회의 꼭 출석해	오늘 회의 출석하기	1
연휴에 동해 일출 보러 가지 않을래	연휴에 동해 일출 보러 가기	1
햇볕을 바로 쬐지 않는 실내 수영장으로 가자	햇볕을 바로 쬐지 않는 실내 수영장 가기	1
펀드매니저들의 운용실적을 보내 주세요	펀드매니저들의 운용실적 보내주기	1
내일은 꼭 이비인후과 다녀와	내일 이비인후과 다녀오기	1
오늘의 축구경기 일정 알려주련	오늘의 축구경기 일정	1
최사장 이번에 안양 쪽에 좋은 건수가 잡혔는데 같이 해볼까	안양 쪽에 좋은 건수 같이 해보기	1
걱정 하지마	걱정하기	0
식탁 위에 밥 차려놨으니까 꼭 먹고 가	식탁 위에 밥 먹고 가기	1
유엔 연합건물 투어가 두시에 있대 거기 가자	유엔 연합건물 투어 가기	1
직장 너무 자주 옮기면 경력에도 나쁘지 않나	직장 너무 자주 옮기기	0
장애인 올림픽 최초 개최국 관련 기사 찾아다오	장애인 올림픽 최초 개최국 관련 기사	1
매일유업입니다 우유하나 드셔보시죠	우유 먹기	1
이번 달에 있는 이벤트 이메일 전부 보여라	이번 달 이벤트 이메일 전부	1
오늘 석간 신문이 들어 왔나 확인해	오늘 석간 신문 여부	1
세탁기를 삼십 분 후에 돌려주라	세탁기 삼십분 후에 돌리기	1
토요일 두시 시계탑 앞에서 보자	토요일 두시 시계탑 앞에서 보기	1
새 메일 중 물품발송 이메일 확인해줄래	새 메일 중 물품발송 이메일	1
사업이 안된다고 해서 쉽게 포기하지 말고 계속 열심히 해라	사업 계속 열심히 하기	2
나 오늘 우울한데 위로해주라	위로해주기	1
투자하는 게 낫지 않겠니 	투자하기	1
다음 달에 공장 인스펙션 있으니까 준비 슬슬 시작하라고	준비 슬슬 시작하기	1
세탁기에 들어있는 빨래를 탈수시켜다오	세탁기에 들어있는 빨래 탈수하기	1
성사가 되면 한턱 쏴	성사가 되면 한턱 쏘기	1
레포트 파일로 보내면 인쇄해서 제출 해 줄 수 있어	인쇄 제출하기	1
빨리 뛰어와	빨리 뛰어오기	1
어머님 과외비 주시는 날이 한참 지났어요	과외비 주기	1
정상까지는 차로 들어갈 수 없으니 이쯤에서 차를 세워두자	이쯤에서 차 세워두기	1
좋은 횟집 알아 놨는데 한번 가야지	좋은 횟집 가기	1
십일월 구일 다섯시까지 동대문 운동장에서 만나	십일월 구일 다섯시까지 동대문 운동장에서 만나기	1
내방의 현재 모습을 동영상으로 보자	내방의 현재 모습 동영상으로 보기	1
오늘 두 시에 회의 있는 거 잊지 않으셨죠	오늘 두 시 회의 참석하기	1
오전까지 교회 앞으로 모여주시기 바랍니다	오전까지 교회 앞으로 모이기	1
논문 제출 마감일을 입력해	논문 제출 마감일 입력하기	1
저 빨강색 수영복을 사서 동해로 해수욕하러 가자	빨강색 수영복 사서 동해로 해수욕 가기	1
날도 좋은데 유람선 타러 가자	유람선 타러 가기	1
아무데나 가자	아무데나 가기	1
얇게 입고 다니면 감기 걸리니까 조심해	얇게 입고 다니기	0
올해엔 대출을 모두 완납해 주시기 바랍니다	올해 대출 완납하기	1
내 방 현재 화면 좀 보여라	내 방 현재 화면 보이기	1
오랜만에 날씨가 너무 좋으니 쇼핑 어때	쇼핑하기	1
검토 후 연락 바랍니다	검토 후 연락하기	1
오늘 꼭 계약서 받아서 와	오늘 계약서 받아오기	1
무료쿠폰 생겼는데 피자헛 가자 	피자헛 가기	1
우리 내일 같이 쇼핑하자	내일 같이 쇼핑하기	1
검사 받으려면 예약해야지	예약하기	1
주식 투자 전략에 관한 잡지를 몽땅 사와라	주식 투자 전략에 관한 잡지 몽땅 사오기	1
맘껏 뛰어 놀게 내버려 둬	맘껏 뛰어 놀게 내버려 두기	1
그쪽이 불리해 우리는 조금 더 튕기자	조금 더 튕기기	1
너 그 은행에 가서 은행장한테 확실히 물어봐야 해	그 은행에 가서 은행장한테 확실히 묻기	1
자료를 잘 분석해서 하나씩 나눠봐라	자료 분석해서 하나씩 나누기	1
요번에 계획한 운동 시간을 변경해	요번에 계획한 운동 시간 변경하기	1
대리운전 불러	대리운전 부르기	1
농구 시즌 끝나면 곧 야구 시즌이니 너무 아쉬워 말라고	아쉬워하기	0
야유회에 개인 돗자리를 꼭 가져오세요	야유회에 개인 돗자리 가져오기	1
그 약속들을 다시 일정에다가 넣어놓을래	약속들 다시 일정에 넣어놓기	1
박세리에 대한 최근 기사를 보여다오	박세리 최근 기사	1
오늘 오후에 올라가는 기차 취소해	오늘 오후 올라가는 기차 취소하기	1
따뜻하게 챙겨 입어	따뜻하게 챙겨 입기	1
몇 시쯤에 만날 거야 네 편한 대로 정해	몇 시쯤에 만날지 편한 대로 정하기	1
열쇠를 잃어버리신 분 찾아가세요	열쇠 잃어버렸으면 찾아가기	1
인터넷 쇼핑몰을 운영하게 됐어 가입해라 	인터넷 쇼핑몰 가입하기	1
그렇지 내 말만 잘 따라	내 말만 잘 따르기	1
얼어붙지 않도록 세차하실 때 조심하세요	얼어붙지 않도록 세차할 때 조심하기	1
사이버 모의 주식을 해보세요	사이버 모의 주식 하기	1
내일 경기도 용인에서 열리는 워크샵에 다들 늦지 말아요 	내일 경기도 용인에서 열리는 워크샵 늦지 않게 오기	0
예외는 있지만 기본적으로 업무메뉴얼에 따라주세요	기본적으로 업무메뉴얼에 따르기	1
노약좌석엔 앉는 거 아니야	노약좌석에 앉기	0
여름에 야외 캠프에 같이 참여하자	여름에 야외 캠프에 같이 참여하기	1
도예를 배우려면 공방에 다녀야지	공방에 다니기	1
오늘의 유머를 보여라	오늘의 유머 보이기	1
해운대 근처 육 인 콘도 예약	해운대 근처 육 인 콘도 예약하기	1
본사와 업무 연락해서 공문 발송하도록 해주세요	본사와 업무 연락해서 공문 발송하기	1
이번 주 대구에서 있었던 일정 확인	이번 주 대구에서 있었던 일정 확인하기	1
소개팅이라고 너무 예쁘게 입지 말고 따뜻하게 하고 와	따뜻하게 하고 오기	2
튕기지 말고 토요일 날 만나요	토요일 날 만나기	2
뭐하고 지내냐 학원 다시 나와 선생님이 걱정하시잖아	학원 다시 나오기	1
정미에게 메일을 보내	정미에게 메일 보내기	1
오늘 종강이래 학교 꼭 와	학교 오기	1
과열된 시장 심리로 인한 주가 상승을 주의해	과열된 시장 심리로 인한 주가 상승 주의하기	1
따뜻하게 입고 다녀	따뜻하게 입고 다니기	1
길 안 막히니깐 그리로 와	그리로 오기	1
앉아서 책만 보지 말고 농구나 한판 뛰자	농구 한판 뛰기	2
시청 로타리 상황을 보여주렴	시청 로타리 상황	1
금연 금주 하지마	금연 금주하기	0
통장의 비밀번호를 함부로 누설하면 안 된다	통장 비밀번호 함부로 누설하기	0
포르쉐 컨셉트 카 발표회 관련 기사를 찾아	포르쉐 컨셉트 카 발표회 관련 기사	1
십이월 사일 바캉스 가자	십이월 사일 바캉스 가기	1
상금 받아서 한 턱 쏴	상금받아서 한턱 쏘기	1
그래 추우니까 우리 따뜻한 거 마시면서 얘기하자	따뜻한 거 마시면서 얘기하기	1
시청 로타리 차량 통행 상황을 보여주렴	시청 로타리 차량 통행 상황	1
이자율이 낮아도 은행 저축을 택해	은행 저축 택하기	1
입학을 축하하며 큰 꿈 키우기 바란다	큰 꿈 키우기	1
주식 이야기도 하지 마 뼈아픈 고통이 있단 말이야	주식 이야기 하기	0
선물옵션 시장을 주시해봐 답이 나올 거야	선물옵션 시장 주시하기	1
담배피면 안 피는 사람도 폐암 걸린다	담배피기	0
한달에 한 십만원 정도씩만 해봐	한달 십만원 정도씩만 해보기	1
테니스 스코어에 대한 기사를 보고 싶어	테니스 스코어 기사	1
이번 주 수요일 함께 저녁 먹고 싶습니다	이번 주 수요일 함께 저녁 먹기	1
우리 정말 그러지 말자	그러기	0
프로야구 홈런레이스 일 위 관련 기사 찾아다오	프로야구 홈런레이스 일 위 관련 기사	1
같이 가지 않을래 	같이 가기	1
티비 채널 음향 설정을 영화로 변경해줄래	티비 채널 음향 설정 영화로 변경하기	1
창쪽 좌석 예약하렴	창쪽 좌석 예야ㅑㄱ하기	1
오늘 촬영 연기 됐어 스케줄 조정 다시 해	스케줄 조정 다시 하기	1
종교관련 서적을 찾아라	종교관련 서적	1
항상 계좌번호를 외워둬	항상 계좌번호를 외워두기	1
너 그렇게 하면 업무 방해죄인 것 몰라	그렇게 하기	0
힘들어도 조금만 버텨라	조금만 버티기	1
해외여행 시 수표는 가져가지마	해외여행 시 수표 가져가기	0
명동 주변의 매운탕 집을 알려다오	명동 주변 매운탕 집	1
뒷베란다 문을 잠궈주라	뒷베란다 문 잠그기	1
자신과의 약속을 지키는 사람이 되라	자신과의 약속 지키는 사람이 되기	1
다음 주 쯤에 얼굴이나 한번 볼까	다음주 쯤에 얼굴 한번 보기	1
사백구십육 번 버스 타는 데 앞에서 오분 후에 보자	사백구십육 번 버스 타는데 앞에서 오분 후에 보기	1
회덕 분기점 도로상황을 보여주렴	회덕 분기점 도로상황	1
현관에 누가 왔는지 좀 알려라	현관에 온 사람	1
티비 하이파이 스테레오로 해놔	티비 하이파이 스테레오로 해놓기	1
안 막히는 구간이 있는가 보여주렴	안 막히는 구간이 있는지	1
꼭 불법유턴을 해야 하는 거야 	불법유턴하기	0
한번 공부하기로 마음 먹었으니 다른 것에는 신경 쓰지 마	다른 것에 신경쓰지 않기	1
그때 갔던 역삼동에 놀부부대찌게 왠지 다시가고싶지 않니	역삼동 놀부부대찌게 다시가기	1
스텐드 조명을 이 단계로 하렴	스탠드 조명 이 단계로 하기	1
갑갑할 때는 교외로 친구들과 드라이브를 가	교외로 친구들과 드라이브 가기	1
아침에 덥다고 옷 얇게 입고 나오지 마	옷 얇게 입고 나오기	0
동아리 연합 엠티 가는 날을 알려라	동아리 연합 엠티 가는 날	1
모범택시 타고 갈 테니까 돈은 네가 내	모범택시 돈 내기	1
꼭 연락처 받아둬	연락처 받아두기	1
건강을 위해서 휴일엔 쉬세요	휴일에 쉬기	1
올림픽 현재 우리나라 메달 순위 관련 기사 찾아다오	올림픽 현재 우리나라 메알 순위 관련 기사	1
칼슘 영양제를 한 번 섭취해 보세요	칼슘 영양제 섭취하기	1
부산 대마도 간 훼리 예약취소	부산 대마도 간 훼리 예약취소하기	1
사월에 한창 벚꽃이 피니까 꽃구경 가자	사월에 꽃구경 가기	1
확고한 주식관을 세우십시오	확고한 주식관 세우기	1
서울시 전역 도로망 한번 보여주렴	서울시 전역 도로망	1
조교해야 하는 시간은 비워 두는 게 좋아	조교해야 하는 시간 비워두기	1
강남근방에선 뛰어나오는 차들을 조심해야 돼	뛰어나오는 차들 조심하기	1
요즘 고유가시대라 정말 대중교통을 이용해야 해	대중교통 이용하기	1
신용카드는 혜택이 많은 걸로 신청해	신용카드는 혜택이 많은 걸로 신청하기	1
동아대학교에서 온 이메일을 찾아줄래	동아대학교에서 온 이메일	1
비디오폰 연결해서 밖에 누가 왔나 보여라	비디오폰 연결해서 밖에 누가 왔나 보이기	1
아기 침대 취소해	아기 침대 취소하기	1
모두들 좌우를 살피고 손을 들면서 길을 건너세요	좌우를 살피고 손을 들면서 길을 건너기	1
준선이에게 답장 쓸 준비해	준선이에게 답장 쓸 준비하기	1
우리나라 공항 예보 보여	우리나라 공항 예보	1
아이티 분야로 한 번 시도해 봐	아이티 분야로 한번 시도해 보기	1
대전행으로 고속철 두 장 예약해	대전행으로 고속철 두 장 예약하기	1
문자로 보내	문자로 보내기	1
배정호가 보낸 편지 휴지통으로 보내	배정호가 보낸 편지 휴지통으로 보내기	1
토요일 학교 정문으로 모이세요	토요일 학교 정문으로 모이기	1
인터넷 쇼핑몰에 관한 정보를 얻고 싶은데요	인터넷 쇼핑몰 정보	1
캡처한 화면을 보여줄래	캡처한 화면 보여주기	1
총무과에 묻지 말고 관리과에 물어보세요	관리과에 물어보기	2
프로야구 올스타전의 일정 관련 기사 찾아주렴	프로야구 올스타전 일정 관련 기사	1
오늘 한반도 기압골 사진을 보여주렴	오늘 한반도 기압골 사진	1
우리 좀 따뜻해지면 김밥 싸서 소풍 가자	따뜻해지면 김밥 싸서 소풍 가기	1
앞으로도 많은 관심 부탁 드립니다	앞으로도 많은 관심 가지기	1
난 약속을 잘 지키는 사람이니까 믿어도 되요	나 믿기	1
세이콤 가동을 시켜 주겠니	세이콤 가동하기	1
기다리지마	기다리기	0
오늘의 운세를 찾아라	오늘의 운세	1
날씨 쌀쌀한데 스웨터 하나 걸치고 나와	스웨터 하나 걸치고 나오기	1
날도 쌀쌀한데 옷 단단히 입고 다니세요	옷 단단히 입고 다니기	1
이번 가을은 꼭 휴가 신청해서 등산하러 가자	이번 가을 휴가 신청해서 등산하러 가기	1
정민철 선수 연봉 사억 원 관련 기사를 찾아줄래	정민철 선수 연봉 사억 원 관련 기사	1
시험범위 뒷부분을 잘 모르겠어 내일 좀 알려줄래 	시험범위 뒷부분 내일 알려주기	1
오늘 회의 제목을 말해줄래	오늘 회의 제목	1
우리 너무 힘썼어 고기 뷔페 한번 가 주자	고기 뷔페 가기	1
차 뒤에 꼭 초보운전이라고 써 붙여	차 뒤에 초보운전 써 붙이기	1
티비 볼륨을 삼 단계만 줄여다오	티비 볼륨 삼 단계 줄이기	1
네이션스컵에 관한 기사를 찾아줄래	네이션스컵 기사	1
아시아 청소년 축구 관련 기사를 찾아볼래	아시아 청소년 축구 관련 기사	1
인터넷 사용요금에 대한 소식을 찾아라	인터넷 사용요금 소식	1
서울 롯데호텔에 예약해	서울 롯데호텔 예약하기	1
몸 아프다고 누워만 있지 말고 운동 좀 해 봐	운동하기	2
안 해 	하기	1
서해 대교 쪽 정말 막혀 그 쪽으로 가지 말고 국도 타	국도 타기	2
선생님과 친해져야 공부를 잘 할 수 있어 	선생님과 친해지기	1
임원들은 여섯 시까지 교회 육층 청년회실에서 만납시다	임원들은 여섯 시까지 교회 육층 청년회실에서 만나기	1
전기 검침일이 언제인지 말해	전기 검침일	1
최경주 선수 근황 관련 기사 찾아줄래	최경주 선수 근황 관련 기사	1
지하철 요금인상에 대한 기사를 보여줄래	지하철 요금인상 기사	1
너 자꾸 빨간 불일 때 건너지 마	빨간 불일 때 건너기	0
안전 거리 확보 하고 다녀	안전거리 확보하고 다니기	1
아이로비야 아빠 어깨 좀 주물러	아빠 어깨 주물러드리기	1
같이 하면 더 빨리 외울 거야 영어 교재 가지고 와	영어 교재 가지고 오기	1
아직도 출발 안 한 거야 냉큼 버스타고 오거라 	버스타고 오기	1
피서 다녀올 테니 집 잘 보고 있어	집 잘 보고 있기	1
교과서 외의 상식 분야를 많이 읽게 해라	교과서 외 상식 분야 많이 읽게 하기	1
여섯시가 되면 알려줄래	여섯시 되면 알려주기	1
오늘 밤에 인천역 팔번 출구에서 보자	오늘 밤 인천역 팔번 출구에서 보기	1
시간 다 됐는데 왜 안 나와	나오기	1
교육 행정직도 괜찮다고 하니깐 한 과목 더 해봐	한 과목 더 해보기	1
전저점 가격대의 현재 거래량을 비교해야 돼	전저점 가격대의 현재 거래량 비교하기	1
다른 길로 와라	다른 길로 오기	1
미루자	미루기	1
배구 하러 가자	배구하러 가기	1
성적에 구애 받지 말고 그냥 교양으로 배우는 건 어때 	교양으로 배우기	2
보행자들은 각별히 유의바랍니다	보행자들은 각별히 유의하기	1
그래도 너무 한 것 같은 데 절약해라	절약하기	1
재테크의 중요성을 일깨우자	재테크하기	1
그러면 병원에 꼭 가봐라 걱정 된다	병원에 꼭 가보기	1
여의도로 자전거 타러 갈까	여의도로 자전거 타러 가기	1
차가 많이 막히니까 퀵서비스 부르자	퀵서비스 부르기	1
인천공항 진입로를 보고싶어	인천공항 진입로	1
자료 복사 하는 일 좀 도와줄래 	자료 복사 하는 일 도와주기	1
머리 많이 아프면 밖에 나가서 바람이라도 쐬고 와	밖에 나가서 바람 쐬고 오기	1
영화표가 당첨되었는데 같이 보러 갈 수 있어 	영화 같이 보러가기	1
김현철에 대한 기사를 모두 찾아라	김현철 기사 모두	1
금요일까지 드로잉 세장 해오래	금요일까지 드로잉 세장 하기	1
스릴을 느끼고 싶으면 래프팅에 한번 도전해봐	래프팅에 한번 도전하기	1
영화티켓예매 다 했으니 여덟 시에 바로 영화관 앞으로 와	여덟 시에 바로 영화관 앞으로 오기	1
이 라디오 방송을 녹음해	이 라디오 방송 녹음하기	1
잠실대교 상황을 알 수 있을까	잠실대교 상황	1
전자레인지 우유병 소독 시작해주렴	전자레인지 우유병 소독 시작하기	1
먹고 찍다가 저녁에 올라오자	먹고 찍다가 저녁에 올라오기	1
남산 삼 호 터널은 원활한지 알려다오	남산 삼 호 터널 원활한지	1
초등학생과 선생님들의 많은 참여 바랍니다	초등학생과 선생님들 참여하기	1
어릴 적에 묻어 놓은 타임캡슐 파 보러 가자	타임캡슐 파 보러 가기	1
첫월급 받아서 한턱 내	첫월급 한턱 내기	1
꼭 꼭 약속해 잊으면 안 된다	약속하기	2
인라인 탈 때 장비 잘 갖춰서 타	인라인 장비 잘 갖춰서 타기	1
고생했는데 오늘 저녁 회식이나 합시다	오늘 저녁 회식하기	1
활짝 웃으면 기분 좋은 하루가 될 거예요	활:짝 웃기	1
금연 금주 하지마	금연 금주하기	0
이번 달 받은 성인 제목의 이메일 삭제하렴	이번 달 받은 성인 제목의 이메일 삭제하기	1
레알 마드리드 선수들에 관한 기사를 찾아줄래	레알 마드리드 선수 관한 기사	1
매번 미루지 말고 이번에는 꼭 줬으면 해	이번에는 꼭 주기	1
이번 스승의 날에는 선생님 꼭 찾아 뵙자	이번 스승의 날에 선생님 찾아 뵙기	1
월급통장 하나 개설하세요	월급통장 하나 개설하기	1
안 할거야	하기	1
세탁기 일곱시 십오분에 돌려주겠니	세탁기 일곱시 십오분에 돌리기	1
배터리를 급속 충전해	배터리 급속 충전하기	1
외곽순환 도로 상황을 보여주렴	외곽순환도로 상황	1
버스운전에는 대형면허가 있어야 합니다	버스운전하려면 대형면허 갖기	1
우리 회비 따로 관리하는 통장 하나 만들자	회비 따로 관리하는 통장 하나 만들기	1
어제 신문 논평을 보여라	어제 신문 논평	1
너 자꾸 인사 안 하면 미워한다	인사하기	1
주요 고속도로의 교통상황을 알리렴	주요 고속도로 교통상황	1
그래도 안되면 그래픽카드를 다시 유심히 살펴보라	그래픽카드 유심히 살펴보기	1
요번 달 이벤트 메일을 전부 보이렴	요번 달 이벤트 메일 전부	1
오늘 어음 만기일이야 부도 내지 말고 막아	오늘 어음 만기일 막기	2
실장님께서 찾으세요 빨리 오세요	빨리 오기	1
도로의 구간별 소요 시간을 알려라	도로 구간별 소요 시간	1
주말에 미술관 옆 동물원에서 만나는 걸로 하자	주말에 미술관 옆 동물원에서 만나기	1
인사는 예절입니다 마음을 담아하세요	마음을 담아 인사하기	1
실적이 좋지 않으면 명예퇴직 일 순위라는 걸 명심해	실적 내기	1
회비는 선배는 무조건 배추 잎이에요	회비 배추 잎 내기	1
내일 태풍 온다니까 집에 꼼짝 말고 있어	집에 꼼짝 말고 있기	1
업종선택에 있어서 유연성이 필요해	업종선택에 유연성 가지기	1
그런 것은 외우는 게 아니라 이해해야 해	그런 것은 이해하기	2
그럼 너도 다음 주부터 주전 선수로 뛰는 거야	다음 주부터 주전 선수로 뛰기	1
잠원역 육번 출구에서 전화하면 내가 나갈게	잠원역 육번 출구에서 전화하기	1
허리케인 카트리나에 대한 소식을 보여라	허리케인 카트리나 소식	1
커튼을 반만 쳐라	커튼을 반만 치기	1
야채를 조금 더 먹어야 건강해 질 수 있어	야채를 조금 더 먹기	1
롯데 백화점에서 열린 이벤트 관련 기사 검색해	롯데백화점에서 열린 이벤트 관련 기사	1
이쪽으로 와	이쪽으로 오기	1
스페인에 진출한 이천수 관련 기사 모아주렴	스페인 진출한 이천수 관련 기사	1
태영프라자에서 컴퓨터 무료 강의 해주던데 한번 가봐	태영프라자 컴퓨터 무료 강의 가보기	1
오랜만에 교외로 산책갈래 	교외로 산책가기	1
너희 부모님 주말에 시간 되시는지 여쭤볼래 	부모님 주말에 시간 되시는지 여쭤보기	1
괜찮다 싶으면 면접 약속하면서 만나봐	면접 약속하면서 만나보기	1
날씨가 더워 쉽게 지칠 수 있으니 삼계탕 먹고 힘내자 	삼계탕 먹기	1
현재 남산터널을 지나는데 걸리는 시간은 얼마나 되는지 알려다오	현재 남산터널 지나는데 걸리는 시간	1
광고 팀 모델 캐스팅 들어가세요	광고 팀 모델 캐스팅 들어가기	1
학습지도안이 다 있을 텐데 선생님께 여쭤봐	학습지도안 선생님께 여쭤보기	1
주식 투자는 전문가와 상의를 해서 시작하도록 해	주식 투자는 전문가와 상의해서 시작하기	1
우리 그 유명한 횟집 가보자	유명한 횟집 가보기	1
외출 시에는 행선지와 용무를 메모로 남겨 주십시오	외출 시에는 행선지와 용무 메모로 남기기	1
소이 방 가서 십 분 뒤 알람 세 번 울려주렴	소이 방 가서 십분 뒤 알람 세 번 울리기	1
편식을 안 해야 영양소가 골고루 섭취 되지 	편식하기	0
내일 비 올 확률 보여줄래	내일 비 올 확률	1
금요일 저녁 아홉시 심야기도회에 참석 바랍니다	금요일 저녁 아홉시 심야기도회 참석하기	1
주식을 열심히 연구한 뒤 주식을 매입해	주식을 열심히 연구한 뒤 매입하기	1
가만 있어봐	가만 있기	1
전두환 통장 잔고가 얼만지 보여라	전두환 통장 잔고	1
건강 유지를 위해 수영 배우는 게 어때 	수영 배우기	1
삼 호선을 타고 가는 게 더 빠를 걸	삼호선 타고 가기	1
이번 달에는 생일쿠폰이 나오니까 함께 놀이동산에 가자	함께 놀이동산에 가기	1
저한테 맡겨주세요 열심히 하겠습니다	저한테 맡겨주기	1
모든 모니터 보여라	모든 모니터	1
오늘 춥다니까 옷 두껍게 입고 나와	옷 두껍게 입고 나오기	1
많이 바쁘신가봐요 그래도 꿋꿋이 버티세요	꿋꿋이 버티기	1
이번에 우리 취직하자 동현아	이번에 취직하기	1
내일 우리 유치원 학습발표회야 올 거지 	내일 유치원 학습발표회 오기	1
지하 일 층에 있는 회의실에서 모이는 걸로 합시다	지하 일 층 회의실에서 모이기	1
거기 가만히 있어라	거기 가만히 있기	1
아이로비 저기 좀 가	저기 가기	1
선급 비용에 대해서 회계 처리해	선급 비용에 대해 회계 처리하기	1
버스 타고 가고 있으니까 정류장에 마중 나와	정류장에 마중나오기	1
성사가 되면 한턱 쏴	성사되면 한 턱 쏘기	1
그 컴퓨터 프로그램 가지고 지금 앞으로 나와	컴퓨터 프로그램 가지고 지금 앞으로 나오기	1
삭제된 일정을 검색해	삭제된 일정 검색하기	1
수익이 났으면 하루쯤 쉬어 보는 게 좋아	하루쯤 쉬기	1
뒤풀이할 때 술집 하나 빌리자	뒤풀이 술집 하나 빌리기	1
오늘 온 사람들 담은 화면 좀 보여라	오늘 온 사람들 담은 화면 보이기	1
용인휴게소 주위 교통상황을 보여주렴	용인휴게소 주위 교통상황	1
서울 시내 지체구간은 어딘지 파악해다오	서울 시내 지체구간	1
큰 방으로 건너와	큰 방으로 건너오기	1
캐쉬백 받는 카드를 써	캐쉬백 받는 카드 쓰기	1
이번에 같이 바베큐파티 합시다	이번에 같이 바베큐파티하기	1
만덕터널 공사 상황 알려주련	만덕터널 공사 상황	1
공부 열심히 해	공부 열심히 하기	1
이번 달 쇼핑 이메일 전부 보자	이번달 쇼핑 이메일	1
찜질방에서 너무 땀 빼지 마세요	찜질방에서 너무 땀빼기	0
대출을 받고 싶은데 대출의 효용성을 알려주세요	대출 효용성	1
낙선운동에 대한 기사를 보여라	낙선운동 기사	1
설명할 자료는 각자 준비하세요	설명할 자료 준비하기	1
귀 시릴 테니 코트모자라도 쓰고 다녀	코트모자 쓰고 다니기	1
증권사 직원의 말만 듣고 투자하면 안돼	증권사 직원의 말만 입고 투자하기	0
이따가 다시 얘기하자 전화할게	이따가 다시 얘기하기	1
장학금 타면 한턱 쏴야 한다	장학금 타면 한턱 쏘기	1
요리할 때 되도록이면 소금사용을 줄이세요	요리할 때 소금사용 줄이기	1
아침은 그냥 빵으로 대신하자	아침은 빵으로 대신하기	1
칼슘을 많이 먹어서 뼈를 튼튼하게 하자	칼슘을 많이 먹어 뼈를 튼튼하게 하기	1
챙겨 먹어	챙겨 먹기	1
어서 와야돼 모두 오셨어	어서 오기	1
이 시간 거래량 체크 요망	이 시간 거래량 체크하기	1
한 시간 동안 가만히 있어	한시간 동안 가만히 있기	1
같이 주식 정보 공유 까페 가입하자	같이 주식 정보 공유 까페 가입하기	1
초보일 땐 좌우 잘 살펴야지	좌우 잘 살피기	1
오디오 작동 그만	오디오 작동하기	0
스키는 북유럽으로 타러 가자	스키는 북유럽으로 타러 가기	1
그럼 이빨을 열심히 닦아라	이빨 열심히 닦기	1
내일 저녁 여섯시 이후 모든 약속 취소해	내일 저녁 여섯시 이후 모든 약속 취소하기	1
강원도컵 아이스하키에 관한 기사 찾아주련	강원도컵 아이스하키 기사	1
관리사무실로 연결해 주겠니	관리사무실로 연결하기	1
내일 밤에 성북역 칠번 출구에서 보자	내일 밤에 성북역 칠번 출구에서 보기	1
이번 주말에는 꼭 저랑 같이 가시는 거예요	이번 주말에 같이 가기	1
유럽 챔피언스리그 소식 찾아라	유럽 챔피언스리그 소식	1
그럼 거기서 봐	거기서 보기	1
한의원에 한 번 가보세요	한의원 한번 가보기	1
신갈 분기점 부근을 영상으로 보여주련	신갈 분기점 부근	1
그 횡단보도 건너 백화점 방향으로 돌아	횡단보도 건너 백화점 방향으로 돌기	1
집에 가자마자 샤워하고 푹 자도록 해	집에 가자마자 샤워하고 푹 자기	1
나 돼지꿈 꿨다 복권 사줘	복권 사주기	1
오늘 탁구 경기 관련 기사를 알려	오늘 탁구 경기 관련 기사	1
일기예보 보고 정하자 괜히 비 오거나 하면 어떡해 	일기예뽀 보고 정하기	1
비디오폰으로 경비실 연결해 주겠니	비디오폰으로 경비실 연결하기	1
날씨도 좋은데 교외로 드라이브 가자	교외로 드라이브 가기	1
햇빛이 강하니 썬크림 꼭 해	썬크림 하기	1
잘자고 전화해	잘자고 전화하기	1
그 적금 해약하면 안 돼	그 적금 해약하기	1
주말에 뭐 해 별일 없으면 우리 집 와서 놀자	집에서 놀기	1
오늘 오전 도착 메일을 모두 보여주렴	오늘 오전 도착 메일 모두	1
와이티엔 뉴스채널에 있는 뉴스의 종류 알려주련	와이티엔 뉴스채널 뉴스 종류	1
주식을 열심히 연구한 뒤 주식을 매입해	주식 열심히 연구한 뒤 매입하기	1
그냥 삐끗한 게 아닌 거 같은데 엑스레이 찍어봐	엑스레이 찍어보기	1
너랑 주제가 다른 게 있어 참고 해야 할 거야	다른 주제 참고하기	1
인라인 탈 때 장비 잘 갖춰서 타	인라인 장비 잘 갖춰서 타기	1
이치로 선수 홈런 기사를 알려	이치로 선수 홈런 기사	1
이따 아홉 시에 심야 영화 보러 가자	아홉시에 심야 영화 보러 가기	1
대전행 고속철 두 장 예약해	대전행 고속철 두 장 예약하기	1
문 앞을 계단을 일 분 간격으로 찍어라	문 앞 계단을 일 분 간격으로 찍기	1
욕조 따로 안 사도 물 반만 받음 되지않아	욕소 물 반만 받기	1
예약을 모레로 미뤄둬	예약 모레로 미루기	1
학급회의 삼 만원 이니까 내일까지 가지고 와	학급회의 삼 만원 내일까지 가지고 오기	1
교통 사망사고에 관련된 기사를 찾아라	교통 사망사고 관련 기사	1
오늘 저녁 가족 외식 약속한 날이다 늦지 말아	오늘 저녁 늦기	0
보드 타러 가실래요	보드 타러 가기	1
배가 너무 많이 나온 것 같아요 우리 아침에 운동해요	아침에 운동하기	1
현재 서울시내 사고 지점을 보여주렴	현재 서울시내 사고 지점	1
도서관에서 대출하기 위해 카드가 필요합니다	카드 가져오기	1
냉장고 냉동실 모드를 강으로 해주겠니	냉장고 냉동실 모드 강으로 하기	1
일찍 들어가	일찍 들어가기	1
일요일에 극장가기로 한 약속 추가해	일요일에 극장가기로 한 약속 추가하기	1
이대리 나와 프레젠테이션 마무리 작업 같이 하죠	프레젠테이션 마무리 작업 같이 하기	1
호텔 근처 골프장 예약하렴	호텔 근처 골프장 예약하기	1
당신의 옆에 항상 제가 있을게요 제게 연락주세요	연락주기	1
오늘 전직원이 모여서 회식을 가질 거예요꼭 오세요	오늘 회식 오기	1
재직 증명서 한 부만 출력 하세요	재직 증명서 한 부만 출력하기	1
뭐 먹고 나면 이빨 깨끗이 닦아	뭐 먹고 나면 이빨 깨끗이 닦기	1
차량 안전거리 백미터유지 할 것 	차량 안전거리 백미터 유지하기	1
평택에서 충주 구간의 고속도로 상황을 알려라	평택에서 충주 구간의 고속도로 상황	1
오늘 영화 예약했으니까 같이 보러 가자	오늘 영화 같이 보러 가기	1
지난번에 술 마셨던 곳이 분위기가 좋더라 거기서 또 보자	지난번에 술 마셨던 곳에서 보기	1
뒤에 계신 분 앞으로 나와주시길 부탁드립니다	뒤에 있으면 앞으로 나오기	1
채무자에게 효과적인 변제 방안을 제시해 줄 것을 요구한다	채무자에게 효과적인 변제 방안 제시하기	1
오늘 저녁에 있는 동문회 꼭 올 거지	오늘 저녁 동문회 오기	1
전화기는 제 자리에 있는지 보여다오	전화기 제 자리에 있는지	1
관심 있는 분들의 많은 지원 부탁드립니다	지원하기	1
대북 쌀지원 관련 소식을 찾아줄래	대북 쌀지원 소식	1
불법 소프트웨어는 사용하지 맙시다	불법 소프트웨어 사용하기	0
그래 이따가 뉴욕당구장에서 보자	뉴욕당구장에서 보기	1
티비 에스비에스로 바꿔다오	티비 에스비에스로 바꾸기	1
여긴 급커브 길이라서 위험하니 속도를 줄여	속도 줄이기	1
반드시 세금을 내야 돼	세금 내기	1
저 삼십 분 후면 터미널에 도착해요 마중 나와	마중 나오기	1
애사심을 키우기 위한 방안을 검토해 오시오	애사심을 키우기 위한 방안 검토하기	1
다음의 말을 이메일로 와인샵에 보내줄래	다음의 말을 이메일로 와인샵에 보내기	1
여행사에 내 사진 보내	여행사에 내 사진 보내기	1
귀하의 요금이 미납되어 있으니 즉시 납부 바랍니다	요금 즉시 납부하기	1
각각 졸업사진을 한 부씩 가지고 오시길 바래요	졸업사진 한 부씩 가지고 오기	1
홈시어터의 시디 이 번의 영화를 틀어다오	홈시어터의 시디 이 번의 영화 틀기	1
기록된 것 중 처음 일정을 말해	기록된 것 중 처음 일정	1
솔직히 말해	솔직히 말하기	1
와이티엔 뉴스채널에 있는 뉴스 종류를 알려줄래	와이티엔 뉴스채널 뉴스 종류	1
그 친구는 외국 바이어들이 오면 접대해	외국 바이어들이 오면 그 친구 접대하기	1
아이로비야 안방에서 나와라	안방에서 나오기	1
시험 범위 적고 있어 다음 주부터잖아 준비해야지	시험 준비하기	1
아직 교수님이 도착하지 않으셨어 빨리 와	빨리 오기	1
여윳돈이 생겼다면 장기적으로 보고 조금씩 투자해봐	장기적으로 보고 조금씩 투자하기	1
너무 더워서 오늘 축구하기로 했던 거 취소하자	오늘 축구하기	0
그 사람 하루 빨리 잊고 새 출발 하세요	그 사람 잊고 새 출발하기	1
천천히 가	천천히 가기	1
오늘 메일에서 뉴스 제목이 있는 메일을 보여라	오늘 메일에서 뉴스 제목 있는 메일	1
투자 할 때 욕심은 절대 금물 이야	투자할때 욕심내기	0
어린이대공원 정문 차량 흐름은 어떤지 파악해주련	어린이대공원 정문 차량 흐름	1
감기가 걸리기 전에 예방 주사를 맞아야지	감기 걸리기 전에 예방 주사 맞기	1
이현우 콘서트 이 인 예약	이현우 콘서트 이인 예약하기	1
이빨 다 나으면 시원한 맥주한잔하자	이빨 다 나으면 시원한 맥주한잔하기	1
매주 금요일은 심야기도회가 있습니다 많은 참석 바랍니다	매주 금요일 심야기도회 참석하기	1
횟집은 너무 비싸다 그냥 삼겹살이나 먹자	삼겹살 먹기	1
십 년 후 이곳에서 타입캡슐 같이 열어보자	십 년 후 이곳에서 타임캡슐 같이 열기	1
다시 한번 직접 확인을 해	다시 한번 직접 확인하기	1
서두르지마	서두르기	0
와인 파티에 오셔서 즐거운 시간 가지시길 바랍니다	와인 파티에 오기	1
음주운전 하지마	음주운전하기	0
슬로프에서 혼자 스키를 타는 것은 위험해	슬로프에서 혼자 스키 타기	0
오디오에 올드팝송을 틀어주겠니	오디오에 올드팝송 틀기	1
첫 만남에서는 좀 튕겨	첫만남에서는 튕기기	1
올 여름 전국 기압 배치도를 보여줄래	올 여름 전국 기압 배치도	1
우리 팀 다 같이 저녁 때 한잔해요	다 같이 저녁 때 한잔하기	1
현금으로 주세요	현금으로 주기	1
그 쪽 길은 험해서 사고 위험 있어	그쪽 길 가기	0
주식을 발행할 때 주권에 쓰여진 가격을 잘 살펴보렴	주식을 발행할 때 주권에 쓰여진 가격 살펴보기	1
회원 전체 벚꽃놀이 행사를 준비하였으니 참여 바랍니다	벚꽃놀이 행사 참여하기	1
창문 한번 열어봐요 지금 눈와요	창문 한번 열어보기	1
세부사항은 홈페이지의 공지사항을 참고하시기 바랍니다	세부사항은 홈페이지의 공지사항 참고하기	1
강변 북로 구간의 소통 상황을 알려다오	강변북로 구간 소통 상황	1
이곳에서는 사진 촬영을 금합니다	사진 촬영하기	0
우리나라 역대 동계 올림픽 순위에 대한 소식 찾아라	우리나라 역대 동계 올림픽 순위에 대한 소식	1
이쪽으로 오지마 여기 도로 공사중이다	이쪽으로 오기	0
시장왜곡이나 쏠림 현상에 제발 일희일비하지 말기 바라	시장왜곡이나 쏠림 현상에 일희일비하기	0
목돈 마련 예금에는 어떤 상품이 있는지 알려주라	목돈 마련 예금 상품 종류	1
실패를 했다면 그 원인을 깨달아야 해	실패 원인 깨닫기	1
어젯밤 온 이메일 좀 알려줄래	어젯밤 온 이메일	1
내일 춥다니까 옷 많이 입고 가	내일 옷 많이 입고 가기	1
불면증은 반드시 치료 받도록 해	불면증 치료 받기	1
까쓰오븐 켜줄래	까쓰오븐 켜기	1
부천 대 삼성의 경기에 관한 기사 모아	부천 대 삼성 경기 기사	1
군자교 입구 차량 흐름을 알려주렴	군자교 입구 차량 흐름	1
주식은 많은 공부를 통하여 하셔야만 손실을 막을 수 있습니다	많은 공부하고 주식하기	1
내일로 예약하고 싶은데요	내일로 예약하기	1
업무량을 잘 조정해서 다시 계획서 제출하세요	업무량 잘 조정해서 다시 계획서 제출하기	1
과외가 두 시니까 그 전까지는 와야 돼	두 시 전까지 오기	1
나 다음 주 수요일 날 야외 촬영하는데 같이 가줄래 	다음 주 수요일 날 야외 촬영 같이 가주기	1
잠실대교 북단 교통 흐름 알려주렴	잠실대교 북단 교통 흐름	1
다음에 만날 때 사진 찍은 거 꼭 가져와	다음에 만날 때 사진 찍은 거 가져오기	1
이번 주 스팸도 모두 지워줄래	이번 주 스팸 모두 지우기	1
천호대로 소통상황 보여주렴	천호대로 소통상황	1
내일 회의 끝나고 점심 같이하지	내일 회의 끝나고 점심 같이하기	1
스터디에 오기 전에 미리 예습 하고 오세요	스터디에 오기 전에 예습하고 오기	1
오늘 저녁부터 매일 학교 운동장 다섯 바퀴씩만 뛰자	오늘 저녁부터 매일 학교 운동장 다섯 바퀴씩 뛰기	1
오늘 같이 스쿼시나 하러 갈까 	오늘 같이 스쿼시 하러 가기	1
내일은 한 분도 빠짐없이 참석해 주십시오	내일 참석하기	1
경비 시스템 작동 예약해	경비 시스템 작동 예약하기	1
제조업과 비제조업을 분명히 구분 해둬라	제조업과 비제조업 분명히 구분해두기	1
집들이 할거야 꼭 와야 해	집들이 오기	1
둥근 해가 떴어요 어서 일어나	어서 일어나기	1
지출 내역을 잘 기재 해둬	지출 내역 잘 기재해 두기	1
탑승인원을 지켜주세요 위험합니다	탑승인원 지키기	1
거실의 화면을 녹화한 것을 지워라	거실의 화면 녹화 지우기	1
어젯밤 이메일 중 첨부 파일이 든 이메일은 몇 통이나 되는지 확인해	어젯밤 이메일 중 첨부 파일 든 이메일 수	1
이 개월 뒤 전국체전 일정을 모두 보여라	이 개월 뒤 전국체전 일정 모두	1
인터넷 쇼핑몰에 관한 정보를 얻고 싶은데요	인터넷 쇼핑몰에 관한 정보	1
새 편지 중 주문 확인 메일 확인해	새 편지 중 주문 확일 메일	1
새 편지 중 입근 확인 메일 있는지 확인해주렴	새 편지 중 입근 확인 메일 있는지	1
현관앞의 청소 상태 체크해	현관앞의 청소 상태 체크하기	1
칼슘 좀 챙겨 먹으라구	칼슘 챙겨 먹기	1
핸드볼 신생팀 기사 모아주렴	핸드볼 신생팀 기사	1
교통사고 예방을 잘 지키는 어린이가 되도록 노력하자	교통사고 예방하기	1
박지성 선수의 최근 경기 관련 소식을 찾아다오	박지성 선수 최근 경기 관련 소식	1
학교에 있는 은행 통장 만들면 이리저리 쓰기 쉬우니까 하나 만드는 게 낫지 않을까	학교에 있는 은행 통장 하나 만들기	1
서운한 일은 그때그때 이야기 하기로 해	서운한 일 그때그때 얘기하기	1
겨울에도 자외선에 노출이 되므로 썬 크림을 발라야 한다	썬크림 발르기	1
눈꽃열차 타고 여행 가자	눈꽃열차 타고 여행 가기	1
밥 사주기로 한 거 잊으면 안돼 알았지	밥 사주기	1
게임방 갈까	게임방 가기	1
오늘 일곱시에 예약 했어 그 시간에 봐	오늘 일곱시에 보기	1
밀가루 음식이 몸에 안 좋대	밀가루 음식 먹기	0
천천히 오세요 기다릴께요	천천히 오기	1
교수님 뵈러 갈 때 같이 가자	교수님 뵈러 같이 가기	1
두 달 간 금융에 관련된 기사를 모두 찾아라	두 달 간 금융 관련 기사 모두	1
보험사기 관련 기사를 찾아라	보험사기 관련 기사	1
교통 법규 위반 하지 마	교통 법규 위반하기	0
최경주 선수의 근황에 관련된 기사 찾아주렴	최경주 선수 근황	1
룸은 하늘이 보이는 쪽으로 예약해	룸은 하늘이 보이는 쪽으로 예약하기	1
오늘 모임은 사장님이 주최야 꼭 가자	오늘 모임 가기	1
들어가기 위해선 줄을 서야 합니다	줄 서기	1
일요일 열한 시에 메가박스 앞에서 보자	일요일 열한 시에 메가박스 앞에서 보기	1
경기도 버스도 환승 안되니까 서울 버스인지 보고 타	서울 버스인지 보고 타기	1
시험도 끝났으니 컴퓨터 게임이나 하러 가자	컴퓨터 게임 하러 가기	1
공부할 때는 뚜렷한 목표를 세워	뚜렷한 목표 세우기	1
현재 태풍 경보가 해제된 지역을 알려 주렴	현재 태풍 경보 해제 지역	1
워킹홀리데이 비자 가지고 탈출하자	워킹홀리데이 비자 가지고 탈출하기	1
차표 다 매진 될 지도 모르니까 미리 예약해	차표 미리 예약하기	1
중국 오픈 탁구에 관한 기사를 뽑아주렴	중국 오픈 탁구 관한 기사	1
시끄럽다 조용히 해	조용히 하기	1
축구 대표팀 근황에 관한 기사를 모아줄래	축구 대표팀 근황 기사	1
병원에서 진료 받아 보세요	병원에서 진료받기	1
어젯밤 본 이메일 다 지워줄래	어젯밤 본 이메일 삭제하기	1
야외 활동에 딱 좋은 날씨다 야외로 나가자	야외로 나가기	1
압구정동 근처 미용실 알려	압구정동 근처 미용실	1
에어컨 바람세기를 제일 세게 해줄래	에어컨 바람세기 제일 세게 하기	1
밥 먹은 직후에 운동은 피해	밥 먹은 직후에 운동하기	1
집안에 불 다 꺼졌는지 좀 확인해 줄래	집안 불 다 꺼졌는지	1
소프트웨어 개발에 차질이 생겨서 급히 연락 바랍니다	급히 연락하기	1
오늘의 운세를 찾아라	오늘의 운세	1
이번 주 금요일에 미술관 가지 않을래 	이번 주 금요일에 미술관 가기	1
한국 양궁 장비 과학화에 관한 기사를 찾아줄래	한국 양궁 장비 과학화 기사	1
소이 방에 가서 십 분 뒤에 알람 세 번 울려주련	소이 방에 가서 십분 뒤에 알람 세 번 울리기	1
그래 학교 끝나고 좀 놀자	학교 끝나고 놀기	1
더워도 몸 생각해서 따뜻한 물 마셔	따뜻한 물 마시기	1
위암은 가족력이 있는지도 체크해야 해요	위암 가족력이 있는지 체크하기	1
날도 화창한데 꽃구경이나 갈까	꽃구경 가기	1
목 아프면 이비인후과 가야 돼	이비인후과 가기	1
혼자서 등산 갔다 왔는데 새로운 맛이야 너도 한 번 가봐	혼자서 등산 가보기	1
조금만 더 빨리 해줄 수 있어	조금만 더 빨리 해주기	1
다음 신호등 받고 유턴	다음 신호등 받고 유턴하기	1
남자가 약속을 했으면 지켜야지 응	약속 지키기	1
지하철 노선도 보여주렴	지하철 노선도	1
점심 굶고 저녁 회식 뷔페니까 많이 먹어	많이 먹기	1
정민철 선수 연봉 사억 원과 관련된 기사를 찾으렴	정민철 선수 연봉 사억 원 관련 기사	1
과식을 하지 마세요 비만에 거리기 쉬워요	과식하기	0
피씨방 가자	피씨방 가기	1
소리 줄여주겠니	소리 줄이기	1
남쪽 베란다 창문 보여	남쪽 베란다 창문 보이기	1
오늘 월급 탔어 오빠가 영화 보여줄게 나와	나오기	1
언니 그럼 삼십 분 이따 봐요	삼십 분 이따 보기	1
아빠 약속했는데 왜 선물 안 주는 거야 	선물 주기	1
할인쿠폰 마감 날이 이번 주야 그 전에 한번 가자	이번 주에 한번 가기	1
겨울이 되면 실외 스케이트장 꼭 가보자	겨울이 되면 실외 스케이트장 가보기	1
아무때나 전화해	아무때나 전화하기	1
음식을 골고루 드세요 	음식 골고루 먹기	1
래프팅 하러 가자	래프팅 하러가기	1
남산터널 교통상황에 대해 들려주렴	남산터널 교통상황	1
너무 배고프더라도 천천히 먹어야 체하지 않아	천천히 먹기	1
내일 졸업사진 찍으니까 예쁜 옷 입고와	내일 예쁜 옷 입고 오기	1
나중에 전화 줘 정말 바뻐	나중에 전화주기	1
언제 한번 만나서 회포나 풀자	한번 만나 회포 풀기	1
잊지마	잊기	0
들어가기 싫으면 우리집으로 가자	우리집으로 가기	1
고객 서비스에도 신경 쓰세요	고객 서비스에 신경쓰기	1
대기표 뽑고 기다리고 있어 금방 갈게	대기표 뽑고 기다리기	1
속도 위반은 경찰서로 가셔서 문의 하세요	속도 위반은 경찰서 문의하기	1
현재 원효대교 북단은 교통이 원활하니	현재 원효대교 북단 쇼통 원활한지	1
이제는 수익률보다는 안정성을 고려해서 투자를 해야합니다	수익률보다 안정성 고려해서 투자하기	1
전화해	전화하기	1
주주 총회 못 가시는 분들 위임장 써주십시오	주주 총회 못 가면 위임장 써주기	1
길 많이 막히니까 퀵서비스로 보내	퀵서비스로 보내기	1
택시 앞좌석에선 안전벨트 꼭 메도록 해	안전벨트 메기	1
오븐 속에 뭐가 들어 있는지 보여주라	오븐 속에 든 것	1
김성식한테 온 이메일 확인해줄래	김성식한테 온 이메일 확인하기	1
콜라 좀 주십시요	콜라 주기	1
내가 가방 뒤쪽에 멀미약 넣어 놨으니 먹어	가방 뒤쪽 멀미약 먹기	1
안방 가서 급탕 스위치 켜렴	안방 가서 급탕 스위치 켜기	1
여름에 야외 캠프에 같이 참여하자	여름에 야외 캠프 같이 참여하기	1
트윈으로 예약하고 싶어요	트윈으로 예약하기	1
어머니방 티비 켜져있는지 확인해	어머니방 티비 켜져있는지	1
현재 기상 특보가 발령된 지역을 알려	현재 기상 특보 발령 지역	1
바로 찜질 방 가면 안 된다	바로 찜질방 가기	0
오는 식목일에는 나무를 열 그루씩 심도록 합시다	오는 식목일에 나무 열 그루씩 심기	1
상후가 라면 끓여 놓는데 빨리 와	빨리 오기	1
무소식이 희소식인거야 연락 좀 하고 살자	연락 좀 하고 살기	1
갑자기 운동 심하게 하면 역효과나 슬슬해	갑자기 운동 심하게 하기	0
홍가네된장찌개로 바로 와	홍가네된장찌개로 바로 오기	1
월드컵 이 차 예선 경기 알려라	월드컵 이 차 예선 경기	1
봉사 장학생 신청하실 분은 학과 사무실로 와요	봉사 장학생 신청하려면 학과 사무실로 오기	1
싸우기 싫으면 가만히 좀 있어	가만히 있기	1
귀 시릴 테니 코트모자라도 쓰고 다녀	코트모자라도 쓰고 다니기	1
일 오래하셨는데 그만 쉬세요	쉬기	1
우승기념 행사를 기획해보자	우승기념 행사 기획하기	1
차안에서 뭐 먹으면 안돼	차안에서 먹기	0
한 시간 뒤에 로데오 거리 앞으로 와	한 시간 뒤에 로데오 거리 앞으로 오기	1
여유분 없으니까 아껴서 쓰자	아껴서 쓰기	1
서두르지마	서두르기	0
커피숍에 들어가 있을테니 도착하면 안으로 와	커피숍 도착하면 안으로 오기	1
오전 여덟시 명동교차로 상황을 보여주련	오전 여덟시 명동교차로 상황	1
그런 것은 외우는 게 아니라 이해해야 해	이해하기	2
빨리 달려와	빨리 달려오기	1
주식도 건전하게 해야지 위법한 방법으로 하면 안 된다	주식 건전하게 하기	2
전국 유도 대회 관련 기사를 모아줄래	전국 유도 대회 관련 기사	1
비싼 과외를 하는 것보다 교과서를 보는 게 더 좋아 	교과서 보기	1
뒤쳐지지 않으려면 외국어는 매일 공부해야 해	외국어 매일 공부하기	1
지금 컴퓨터 쓰고 있는 중인데 잠깐 들어올래 	잠깐 들어오기	1
그거 예금통장으로 넣으면 되	그거 예금통장으로 넣기	1
종로 쪽에 또 시위한다 이쪽 길 많이 막히니까 오지마	종로 쪽 오기	0
나 별로 살거 없으므로 끝나고 만나	끝나고 만나기	1
이런 날에는 두꺼운 외투를 걸치는 편이 좋아요	두꺼운 외투 걸치기	1
저녁에 만날 때 내가 빌려줬던 옷 가지고 와라	저녁에 만날 때 빌려줬던 옷 가지고 오기	1
요새 인터넷 쇼핑몰 사업이 뜬다던데 나랑 한 번 해볼래	인터넷 쇼핑몰 같이 하기	1
펀드들의 반응을 잘 살펴보고 와라	펀드들 반응 잘 살펴보고 오기	1
이마트 주차장이야 칠 층으로 와	이마트 주차장 칠 층으로 오기	1
너의 생일날은 꼭 파스타를 먹으러 가자	생일날 파스타 먹기	1
몸도 찌푸둥하니 찜질방 가자	찜질방 가기	1
흥분하지 마세요 	흥분하기	0
서재로 가라	서재로 가기	1
내일 오전 예상되는 적설량을 알려줄래	내일 오전 예상 적설량	1
투자액은 월급의 십 퍼센트 이내로 하자	투자액은 월급의 십 퍼센트 이내로 하기	1
내가 아는 한의원 원장님 침 잘 놓는데 같이 가자	내가 아는 한의원 같이 가기	1
이번 올리픽 순위에 관한 소식을 찾아줄래	이번 올리픽 순위 소식	1
개강하면 간만에 여유롭게 놀자	개강하면 여유롭게 놀기	1
부동산 말고 해외 펀드 투자를 해 보는 것이 어때 	해외 펀드 투자하기	2
건강 생각해서 보험 하나 들어 둬	보험 하나 들기	1
벼락 칠 땐 위험하니까 밖에 나가지 마	밖에 나가기	0
서울에서 대전으로 가는 도로 상황을 알고싶어	서울에서 대전으로 가는 도로 상황 보이기	1
최대한 일찍 만날 수 없을까 	최대한 일찍 만나기	1
어제 생활한자를 보여주렴	어제 생활한자	1
집에서 뵈어도 괜찮을까요	집에서 보기	1
기존 업계의 시장점유율을 조사해 보세요	기존 업계 시장점유율	1
올 때 혼자서 오지 말고 애인이랑 오세요	올 때 애인이랑 오기	2
진짜 듣기 싫은 교양과목은 한 날로 몰아	듣기 싫은 교양과목 한 날로 몰기	1
우리가 계획 했던 거 오늘 만나서 하자	계획했던 거 오늘 만나서 하기	1
영양제를 한 대 맞고 가세요	영양제 한 대 맞고 가기	1
기분도 꿀꿀한데 외식이나 하자	외식하기	1
텔레비전을 케이블 방송으로 전환해줄래	텔레비전을 케이블 방송으로 전환하기	1
애들은 앞좌석에 태우지 말고	애들 앞좌석에 태우기	0
그쪽이 불리해 우리는 조금 더 튕기자	조금 더 튕기기	1
한일 월드컵에서의 붉은악마들의 활약상에 대한 기사를 보여다오	한일 월드컵 붉은악마들 활약상 기사	1
삼십주년 동창회 꼭 올 거지 	삼십주년 동창회 오기	1
우리 시험 끝나고 놀러 가자	시험 끝나고 놀러가기	1
자동차 안에서 에어컨을 틀어 놓고 잠들면 위험해	자동차 안에서 에어컨 틀어 놓고 자기	0
가을인데도 이제 꽤 춥다 두둑하게 챙겨 입고 다녀	두둑하게 챙겨 입고 다니기	1
오늘 더우니까 밖에서 너무 오래 있지 마	밖에서 너무 오래 있기	0
장외 종목은 제외 시키세요	장외 종목 제외하기	1
우리 돈 모으자 곧 여름휴가잖아	돈 모으기	1
퀴즈 팔십 점 이하는 재시험 입니다	퀴즈 팔십 점 이하는 재시험 보기	1
이십오일 모임이야 꼭 나와야 돼	이십오일 모임 나오기	1
입출금이 자유로운 통장도 하나 있으면 좋아	입출금이 자유로운 통장 준비하기	1
시험 예상 문제 같이 뽑아볼까	시험 예상 문제 같이 뽑아보기	1
장기투자의 안목을 가지는 게 좋습니다	장기투자의 안목을 가지기	1
이천 사년 구월 일일이 무슨 요일인지 찾아다오	이천 사년 구월 일일 요일	1
룸은 하늘이 보이는 쪽으로 예약해	룸은 하능리 보이는 쪽으로 예약하기	1
진료비 영수증 꼭 받아 와	진료비 영수증 받아오기	1
현금을 전부 수표로 바꿔 둬	현금을 전부 수표로 바꾸기	1
이메일 작성 준비해	이메일 작성 준비하기	1
목마르다 우리 식혜 마시자	식혜 마시기	1
그 회사 자료 필요해 빨리 넘겨	그 회사 자료 빨리 넘기기	1
케이비에스일 티비로 돌려	케이비에스일 티비로 돌리기	1
매일 같이 우유를 마시는 것이 너한테 좋아	매일같이 우유를 마시기	1
부모님들은 아이들의 손을 반드시 잡아주십시오	아이들의 손 잡아주기	1
이시간이면 버스 안다닐 거야 택시타고 들어와 	택시타고 들어오기	1
지금 시간이 몇 신데 불러내고 난리야 날 밝고 나서 연락해	날 밝고 나서 연락하기	1
침대는 싱글로 예약해	침대 싱글로 예약하기	1
모르는 부분들은 김주임님께 여쭈어 보세요	모르는 부분들 김주임님께 여쭈어보기	1
최면요법 치료를 한번 받아보는 건 어때 	최면요법 치료 받아보기	1
베스트오피스 앞에서 조금 후에 보자	베스트오피스 앞에서 조금 후에 보기	1
쇼핑하기 좋은 데 알아 놨어 같이 가자	쇼핑 같이 가기	1
중국 가는 비행기표 예약해보자	중국 가는 비행기표 예약하기	1
부엌의 모든 등을 꺼라	부엌의 모든 등을 끄기	1
스팸 이메일함을 모두 비워줄래	스팸 이메일함 모두 비우기	1
오토바이 탈 때엔 옷을 되도록 두껍게 입으세요	옷 되도록 두껍게 입기	1
독서도 좋지만 건강을 위해서 스포츠를 즐겨보자고 	건강을 위해서 스포츠 즐기기	1
한명도 빠짐없이 수업에 참여 하라셔	수업에 참여하기	1
둘째의 학원 진도표 좀 보여라	둘째 학원 진도표	1
휴양지 예약이 마감되었으니 다른 지역 검토 바랍니다	휴양지 예약 다른 지역 검토하기	1
생활 질서 위반행위를 집중 지도 단속할 예정이니 과태료 처분을 받지 않도록 유의하십시오	생활 질서 위반행위 하기	0
태권도 관련 기사 찾아다오	태권도 관련 기사	1
차례차례 입장하여 주시길 바랍니다	차례차례 입장하기	1
난희가 오늘 귀국했다니 다 같이 모이자	오늘 다 같이 모이기	1
시사회 표 생겼어 같이 가자	시사회 같이 가기	1
국립 중앙 박물관 관련 기사 찾아라	국립 중앙 박물관 관련 기사	1
음주운전은 절대로 하면 안 돼 알았지	음주운전하기	0
지금 나 체육관에 가는 길인데 같이 가지 않을래	체육관 같이 가기	1
애니콜 프로 농구에 관한 기사를 정리해서 보여	애니콜 프로 농구 기사	1
서울시내 마을 버스 노선 기사를 찾아	서울시내 마을 버스 노선 기사	1
울지마 임마 내가 있는데 왜 우는 거야	울기	0
빨리 와야돼	빨리 오기	1
우리 좀 따뜻해지면 김밥 싸서 소풍 가자	좀 따뜻해지면 김밥 싸서 소풍 가기	1
정기 예금은 가입기간이 짧아도 신청자가 적으면 당첨될 수도 있으니 신청해봐	정기 예금 신청하기	1
영어 회화도 꾸준히 해야 효과가 좋대	영어 회화 꾸준히 하기	1
공부 하러 가자	공부하러 가기	1
제 명의의 계좌의 은행 입출금 거래 내역을 뽑고 싶어요	제 명의 계좌 은행 입출금 거래 내역 뽑기	1
그 프로그램을 따로 짜는 것이 좋을 것 같아	그 프로그램 따로 짜기	1
사업을 잘하려면 깔끔한 복장은 필수야	깔끔한 복장 갖추기	1
우리 오랜만에 만나서 회포를 풀자	오랜만에 만나서 회포를 풀기	1
소외된 주식은 거들떠보지도 않는 게 좋아	소외된 주식 거들떠보기	0
차 한 잔 하면서 잠시 여유를 가져봐	차 한잔 하면서 잠시 여유 가지기	1
연락처를 남겨주시면 곧 연락해 드리겠습니다	연락처 남기기	1
너 하기 싫으면 관둬	관두기	1
돌찬치 강남역에 있는 뷔페에 참석하셔서 축하바랍니다	강남역 뷔페 참석하기	1
너무 빨리 나간다고 생각하시면 뒤에서 경적을 울려주세요	너무 빨리 나간다고 생각하면 귀에서 경적 울리기	1
알립니다 오늘 반지계는 한우정으로 모이세요	반지계 한우정으로 모이기	1
자신과의 약속을 지키는 사람이 되라	자신과의 약속을 지키는 사람이 되기	1
자외선 지수가 높다라네 모자 쓰고 나가	모자 쓰고 나가기	1
우리 그럼 몇 년 뒤에 만나는 거야	몇 년 뒤에 만나기	1
숙소 예약을 해야 되니 사전 등록 바랍니다	사전 등록하기	1
오늘 유가 보여줄래	오늘 유가	1
우루과이 평가전 소식을 뽑아줄래	우루과이 평가전 소식 뽑기	1
월급 탔으니 한턱 쏘마 나와	나오기	1
너무 그렇게 다그치면 학습에 오히려 마이너스야	다그치기	0
너 하기 싫으면 관둬	관두기	1
형들 학교 앞 호프집에서 술 먹는다고 거기로 오래	학교 앞 호프집으로 오기	1
텔레비전 음성다중을 스테레오로 바꿔주겠니	텔레비전 음성다중을 스테레오로 바꾸기	1
유월 이십일까지 끝내야 돼	유월 이십일까지 끝내기	1
설 연휴 사건 사고 관련 기사를 찾아라	설 연휴 사건 사고 관련 기사	1
화 내지마	화내기	0
열 시에 우리 과 축구 예선 있어 응원 가자	열 시 우리과 축구 예선 응원가기	1
저 절대로 잊으시면 안 돼요	저 잊기	0
친구들과의 교우 관계를 원만히 할 수 있는 것도 중요해	친구들과의 교우 관계 원만히 하기	1
청소기를 작동시켜	청소기 작동하기	1
선물과 연계해서 생각해	선물과 연계해 생각하기	1
과제에 너무 신경 쓰지 마	과제에 너무 신경쓰기	0
흡연은 자학행위야 끊어	흡연하기	0
통역할 사람 좀 알아봐	통역할 사람 알아보기	1
서울시 진입로의 지체구간은 어딘지 알려다오	서울시 진입로 지체구간	1
잠수 하러 가자	잠수하러 가기	1
빠지지마	빠지기	0
이제 추워도 내가 못 안아주니까 두꺼운 옷을 장만해	두꺼운 옷 장만하기	1
아테네 올림픽에서 수영과 관련된 기사를 찾아주렴	아테네 올림픽 수영 관련 기사	1
선풍기 바람을 좀 약하게 해주라	선풍기 바람을 약하게 하기	1
강당에서 예금상품관련 특강 있으니까 들어	강당에서 예금상품관련 특강 듣기	1
골프 칠 때는 팔을 쫙 펴야 합니다	골프칠 때 팔 쫙 펴기	1
아마추어로써 준비한 이번 공연 꼭 구경 와 줄 거지 	이번 공연 구경 와주기	1
지엠오 관련 기사를 찾아라	지엠오 관련 기사	1
밤늦게 택시 타는 거 위험하니까 일찍 일찍 들어와 	일찍 들어오기	1
귀찮아도 좀만 참으면 되	좀만 참기	1
내일 서리가 낄 확률을 보여줄래	내일 서리 낄 확률	1
외로울 땐 운동이라도 해서 상념을 없애자	운동이라도 하기	1
배터리를 충전기에 끼워 넣어라	배터리를 충전기에 끼워 넣기	1
까쓰오븐 끄고 잠가	까쓰오븐 끄고 잠그기	1
기대수익률과 요구수익률이 높은지 잘 따져봐	기대수익률과 요구수익률이 높은지 따져보기	1
어젯밤 새 메일 중 공지 이메일 찾아줄래	어젯밤 새 메일 중 공지 이메일	1
너는 나에게 시집올 때 아무것도 준비할 필요 없어	나에게 시집올 때 준비하기	0
금융정보 유료사이트는 사용할 때 주의해야 해	금융정보 유료사이트 사용할 때 주의하기	1
불필요한 레지스트리 정보가 확인되오니 삭제바랍니다	불필요한 레지스트리 정보 삭제하기	1
알람 설정해	알람 설정하기	1
공식적으로 업무 요청 공문 보내 주십시오	공식적으로 업무 요청 공문 보내기	1
엄마가 청소하라고 한 거 꼭 해야 해	청소하기	1
리모콘을 찾아라	리모콘 찾기	1
살도 뺄 겸 좀 걸어라	좀 걷기	1
광고 붙은 이메일은 다 지워줄래	광고 붙은 이메일 다 지우기	1
다음 주에 우리 쇼핑 같이 가자	다음 주 쇼핑 같이 가기	1
어제 태풍 주의보 해제된 지역 보여줄래	어제 태풍 주의보 해제 지역	1
주말인데 놀러 가서 예쁜 사진 찍고 오자	놀러 가서 예쁜 사진 찍기	1
절전 시 전원 스위치부터 확인 바랍니다	절전 시 전원 스위치부터 확인하기	1
세탁기 탈수 시간 좀 조정하고 와	세탁기 탈수 시간 조정하고 오기	1
아이스하키 관련 기사 알려주렴	아이스하키 관련 기사	1
환상의 섬 외도로 떠나자고	외도 가기	1
테니스 치러 가자	테니스 치러 가기	1
비 온다고 우울해 하면 안 돼 오늘 하루도 파이팅	비 온다고 우울해 하기	0
최희섭의 최근 현황 관련 기사 찾아	최희섭 최근 현황 기사 	1
어젯밤 받은 스팸 이메일을 전부 삭제해줄래	어젯밤 받은 스팸 이메일 전부 삭제하기	1
경비실을 좀 연결해	경비실 연결하기	1
회사에서 온 메일 삭제해	회사에서 온 메일 삭제하기	1
빨리 병원 가는 게 좋겠다	빨리 병원 가기	1
지금 인천가는 길은 어떤지 보고싶어	지금 인천가는 길	1
내일 밤에 삼송역 이번 출구에서 보자	내일 밤 삼송역 이번 출구에서 보기	1
육참 총장기 사격에 관한 기사를 찾아줄래	육참 총장기 사격 관한 기사	1
노트북 한대 사줄꺼지	노트북 한대 사주기	1
아침 안 먹었지 샌드위치 먹으러 갈까 	샌드위치 먹으러 가기	1
그 병원에 입원했어 같이 가자	병원 같이 가기	1
이리와	이리 오기	1
경부 고속도로의 교통상황을 말해주라	경부 고속도로 교통상황	1
집에서 꾸준히 주식공부를 하세요	집에서 꾸준히 주식공부하기	1
알림을 시간 맞춰 확인해 주시기 바랍니다	알림을 시간 맞춰 확인하기	1
여유 돈 있으면 우리 회사 주식에 투자해	우리 회사 주식에 투자하기	1
선물 사줄꺼지	선물 사주기	1
수능도 얼마 안 남았는데 춥다고 아랫목에 누워만 있어	아랫목에 누워있기	0
졸업 전시회가 곧 열려 놀러 와	졸업전시회 놀러오기	1
장애인 올림픽에 관한 기사를 보여줄래	장애인 올림피게 관한 기사	1
삼 일 후 오리엔테이션에 참석하시기 바랍니다	삼일 후 오리엔테이션 참석하기	1
성수 제이시 월릉교간 통행에 소요되는 시간을 보여라	성수 제이시 월릉교간 통행에 소요되는 시간	1
김윤희씨 현대정신병원에서 입원부탁합니다	김윤희씨 현대정신병원에서 입원하기	1
맞기 싫으면 내 말대로 해	내 말대로 하기	1
학과사무실 가서 결석계 받아 가	학과사무실 가서 결석계 받기	1
천호대교 지금 정체되는 구간을 보자	천호대교 지금 정체 구간	1
빨리 뛰어와	빨리 뛰어오기	1
티비 켜주겠니	티비 켜기	1
선생님이 뒤풀이 한다고 다 모이래	모이기	1
우리 함께 공부에 빠져 볼까 	함께 공부에 빠지기	1
영화보기 위해 좀 만났으면 한다	만나서 영화보기	1
김치냉장고의 온도를 영하 일 도로 맞춰주련	김치냉장고 온도 영하 일 도로 맞추기	1
비가 올 것 같으니 우산을 휴대 하세요	우산 휴대하기	1
게임중독과 관련된 뉴스를 보여라	게임중독 관련 뉴스	1
각 동의 대표 분들은 관리 사무소로 모여 주시기 바랍니다	각 동의 대표 관리 사무소로 모이기	1
현대 하이닉스 관련 기사를 찾아라	현대 하이닉스관련 기사	1
웬만하면 그 약속 취소하면 안될까 	그 약속 취소하기	1
나 벌써 도착 했어빨리 좀 와라	빨리 오기	1
철저히 따져보고 약속하자	철저히 따져보고 약속하기	1
삼십 분 뒤에 우리 늘 가던 게임방 앞에서 보자	삼십 분 뒤에 늘 가던 게임방 앞에서 보기	1
아무래도 가슴 근육부터 조금씩 키워나가야 할 것 같아	가슴 근육부터 조금씩 키워나가기	1
다음 설명회 때는 늦지 말고 참석해주십시오	다음 설명회 때 늦지 말고 참석하기	0
거실을 세 바퀴 돌아	거실 세 바퀴 돌기	1
김일성 주석이 포함된 소식을 찾아라	김일성주석 포함된 소식	1
이 물건은 깨지기 쉬우므로 조심이 다뤄주십시오	이 물건 조심이 다루기	1
별로 한 것도 없는데 오늘 종일 쳐지는 기분이야 너라도 힘내	힘내기	1
처음의 투자 마인드를 유지하라	처음의 투자 마인드 유지하기	1
이 메일 학교 친구 그룹에 모두 보내	이 메일 학교 친구 그룹에 모두 보내기	1
삐치지마	삐치기	0
주요 고속도로 현재 교통상황을 알려라	주요 고속도로 현재 교통상황	1
뒤에서 무릎 구부릴 때 찍은 사진 가지고 계세요	뒤에서 무릎 구부릴 때 찍은 사진 가지고 있기	1
이십일 여덟 시 반까지 오셔서 입원수속 받으시면 됩니다	이십일 여덟시 반 입원수속 받기	1
교육 행정직도 괜찮다고 하니깐 한 과목 더 해봐	한 과목 더 해보기	1
내일 폭우 쏟아진다니까 집에 얌전히 있어라	내일 집에 얌전히 있기	1
아테네 올림픽에서 수영 관련 기사 찾아주렴	아테네 올림픽 수영 관련 기사	1
한국의 신용등급 상향조정에 대한 기사를 검색해	한국 신용등급 상향조정 기사	1
과일 섭취를 많이 하세요	과일 섭취 많이 하기	1
외출 시에는 마스크하고 다닙시다	외출 시에는 마스크하고 다니기	1
모임 발신자 중 정모 이메일이 있는지 확인해줄래	모임 발신자 중 정모 이메일 여부	1
폐장하기 전에 스키장 한 번 더 가자	폐장하기 전에 스키장 한번 더 가기	1
예비 소집일 가야 하는 거야	예비 소집일 가기	1
프로축구 개막일 관련 기사 찾아주렴	프로축구 개막일 기사	1
두려워 말고 대출 한 번만 부탁해	대출 하기	2
맵고 짠 음식은 너무 좋아 하지마라	맵고 짠 음식 좋아하기	0
오늘은 그냥 푹 쉬자	오늘 푹 쉬기	1
무소식이 희소식인거야 연락 좀 하고 살자	연락 좀 하고 살기	1
이 빌딩은 외부에서 들어오는 음식물 반입을 금지합니다	외부에서 음식물 들여오기	0
우리 금요일 날 여기서 보는 거야	금요일 날 여기서 보기	1
텔레비전 음성다중을 스테레오로 바꿔주겠니	텔레비전 음성다중을 스테레오로 바꾸기	1
펀드 용어 사전이 따로 있는데 한번 찾아 봐	펀드 용어 사전 찾아보기	1
신불자 구제에 대해 찾아라	신불자 구제	1
적당한 운동으로 지금과 같은 건강 유지하시기 바랍니다	적당한 운동하기	1
어리석게 주식에 빠지지 말고 성실하게 적금이나 부어라	성실하게 적금 붓기	2
이천수 소속팀 관련 기사를 찾아라	이천수 소속팀 관련 기사	1
저 베란다가서 문 열렸나 보고와	문 열렸는지	1
지금 은행이거든 이쪽으로 와	이쪽으로 오기	1
예약 시간을 여덟시로 바꿔	예약 시간 여덟시로 바꾸기	1
동창이 유급휴가 나왔으니 모두 가서 축하해주자	도앙 유급휴가 축하해 주기	1
자꾸 약속 어기면 너랑 안 놀아	약속 어기기	0
산성비 맞지 않도록 주의해	산성비 주의하기	1
최신영화 섹션 보여라	최신영화 섹션	1
목돈을 정기예금 할 때는 절대 한 계좌로 만들지 말아라	목돈 정기예금 한 계좌로 만들기	0
시험 성적이 발표되었데 바로 확인해서 전화줄래 	시험 성적 확인해서 전화주기	1
많은 참석 부탁드립니다	참석하기	1
최근 일 주일 간 보낸 메일 전부를 보이렴	최근 일 주일 간 보낸 메일 전부	1
돌발상황이 발생한 구간은 어딘지 보여다오	돌발상황 발생 구간	1
멀리 보고 살아 이 순간 어려운 일이라고 회피하지 말고	멀리 보고 살기	2
여기 난리 났어 연예인 왔거든 너도 보고 싶으면 빨리 와	빨리 오기	1
보드 타러 갈까	보드 타러 가기	1
아침 밥을 먹고 다녀야 위궤양에 안 걸린다 	아침밥 먹고 다니기	1
너는 그냥 사물함 자물쇠랑 운동화만 갖고가면되	사물함 자물쇠랑 운동화만 갖고가기	1
한의원에 한 번 가보세요	한의원 가보기	1
찜질방에서 너무 땀 빼지 마세요	너무 땀 빼기	0
들어 올 때 김밥사오는 거 잊지마	들어올 때 김밥사오기	1
경부 고속도로 상행선 방향의 상황 알려주렴	경부고속도로 상행선 방향 상황	1
육군 내 자살 사건에 관한 기사를 찾아라	육군 내 자살 사건 기사	1
아무런 부담 없이 하루에 한 통씩 메일 보내라고 하셨어요	하루에 한 통씩 메일 보내기	1
영동대교의 영상 정보를 볼 수 있니	영동대교 영상 정보	1
우리 이번 주에 심야 영화 보러 갈까 	이번 주에 심야 영화 보러 가기	1
요즘 벚꽃이 만개했던데 여의도 갈까 	여의도 가기	1
주요 고속도로 현재 교통상황을 알려주련	주요 고속도로 현재 교통상황	1
점심에 마르쉐 앞으로 와서 연락해	점심에 마르쉐 앞으로 와서 연락하기	1
절대 방심하지 말고 외국 투자자의 움직임을 잘 살펴	외국 투자자의 움직임 살피기	2
오빠가 도시락 싸오는 거 잊지 마	도시락 싸오기	1
복날에 삼계탕 먹으러 가자	복날에 삼계탕 먹으러 가기	1
금요일 미팅 시간 세 시간 후로 연기	금요일 미팅 시간 세 시간 후로 연기하기	1
최경주 선수의 근황에 관련된 기사를 찾아볼래	최경주 선수 근황 관련 기사	1
책임이 과중하다면 다른 사람에게 위임하라	다른 사람에게 위임하기	1
내 휴대폰이 충전 다 됐는지 좀 보여줄래	내 휴대폰 충전 여부	1
집에 큰아버지 오셨다 집에 빨리 들어와라	집에 빨리 들어오기	1
요즘 인라인이 대유행이라는데 같이 배울까 	인라인 같이 배우기	1
프로야구 순위 관련 기사를 찾아볼래	프로야구 순위 관련 기사	1
자신과의 약속을 작은 것부터 실천해 나가 보세요	자신과 약속을 작은 것부터 실천해 나가기	1
공부 열심히 해	공부 열심히 하기	1
북부 해수욕장 입구로 삼십 분까지 와	북부 해수욕장 입구로 삼십 분까지 오기	1
지하철 제일 앞 칸 쪽에서 기다리는 거다	지하철 제일 앞 칸 쪽에서 기다리기	1
인상 쓰지 말고 기지개 활짝 펴고 웃어봐요	기지개 활짝 펴고 웃기	2
공기 좋은 데서 좀 쉬다와	공기 좋은 데서 쉬다 오기	1
된장같은 발효식품이 건강에 좋아	발효식품 먹기	1
철도청 홈페이지로 가서 예약하면 돼	철도청 홈페이지로 가서 예약하기	1
버스 정류장에서 기다리고 있어 빨리 나와	빨리 나오기	1
사 번 트랙이요	사 번 트랙 틀기	1
매일 학교까지 데려다 주기로 했잖아요	매일 학교까지 데려다 주기	1
와이티엔 뉴스채널 뉴스 종류 알려	와이티엔 뉴스채널 뉴스 종류	1
내일 약속 미뤄서 다음주에 만나면 안될까	내일 약속 미뤄 다음주에 만나기	1
전화 요망	전화하기	1
정말 완벽하게 익힌 후에야 분석과 투자에 나서도록 해	완벽하게 익힌 후 분석과 투자에 나서기	1
옷 사줄꺼지	옷 사주기	1
회의 문서가 유출되지 않게 신경을 쓰세요	회의 문서가 유출되지 않게 신경쓰기	1
과제에 너무 신경 쓰지 마	과제에 너무 신경쓰기	0
연기하자	연기하기	1
까쓰불 켜졌는지 확인해	까쓰불 켜졌는지 확인하기	1
테잎의 한 면만 듣고 전원 오프해	테잎의 한 면만 듣고 전원 오프하기	1
조명 조금 어둡게	조명 조금 어둡게 하기	1
지엠오 관련 기사를 찾아라	지엠오 관련 기사	1
강남역 칠 번 출구 앞으로 모여	강남역 칠 번 출구 앞으로 모이기	1
이번주 과제물은 파워포인트로 작성해주세요	이번주 과제물 파워포인트로 작성하기	1
고교 아이스하키에 관한 기사를 찾아줄래	고교 아이스하키 관한 기사	1
작년 전국 주요 도시 기후표를 보이렴	작년 전국 주요 도시 기후표	1
이 규칙에 따라서 문서를 작성하세요	이 규칙에 따라서 문서 작성하기	1
야채는 건강에 정말 좋아	야채 먹기	1
내가 열두시까지 갈 테니까 나와 있어요	열두시까지 나와 있기	1
늘 기도를 쉬지 않으시는 여러분들 되길 바랍니다	늘 기도를 쉬지 않기	1
공부할 분위기를 만들어	공부할 분위기 만들기	1
대형우량주를 사는 게 좋을 거야	대형우량주 사기	1
화 내지마	화내기	0
횡단 보도를 건널 때는 꼭 손을 들어라	횡단 보도를 건널 때 손 들기	1
까치골에 있는 술집을 예약해	까치골에 있는 술집 예약하기	1
세탁기 행굼 탈수 모드로 바꿔줄래	세탁기 행굼 탈수 모드로 바꾸기	1
업무에 관계없는 잡담은 삼가주세요	업무에 관계없는 잡담 삼가기	0
좀 빨리 빨리 해줄 수 없어	빨리 해주기	1
한번 열심히 해봐 꼭 성공하기를 빈다	열심히 해보기	1
싸우기 싫으면 가만히 좀 있어	가만히 있기	1
머리 아프다고 자꾸 약 먹으면 안돼요	자꾸 약 먹기	0
한국의 국가 경쟁력 관련 기사를 찾아라	한국 국가 경쟁력 관련 기사	1
너무 비싸요 다시 한번 가격 조정 부탁 드립니다	다시 한번 가격 조정하기	1
화 푸세요	화 풀기	1
문을 열 때 뒤에 오토바이를 조심해요	문을 열 때 뒤에 오토바이 조심하기	1
기다려 곧 갈께	기다리기	1
야채를 많이 드세요 고기만 드시면 안 좋아요	야채 많이 먹기	2
테레비 켜주겠니	테레비 켜기	1
스키 타러 갈래	스키 타러 가기	1
좋은 입지 조건이 있으니까 계약을 위해 이따 뵙죠	이따 계약하기	1
병원에 가봐	병원 가기	1
조금 더 와	조금 더 오기	1
북부 순환도로 상황을 보고싶어	북부 순환도로 상황	1
소개팅 시켜준다고 약속하고 왜 전화 없니 	소개팅 시켜주기	1
오늘 춥다니까 옷 두껍게 입고 나와	옷 두껍게 입고 나오기	1
주식은 여윳돈으로 해야한다는 것을 잊지 마	주식은 여윳돈으로 하기	1
삼십주년 동창회 꼭 올 거지 	삼십주년 동창회 오기	1
선풍기 바람을 좀 약하게 해주라	선풍기 바람 약하게 해주기	1
주말에 나랑 교보문고에 책 보러 가자	주말에 교보문고에 책 보러 가기	1
잠실 롯데 월드 가자	잠실 롯데월드 가기	1
모래 위는 뜨거우니까 슬리퍼를 신고 걸어	슬리퍼 신고 걷기	1
울세탁 해주겠니	울세탁하기	1
최근에 독일축구 관련 기사가 있는지 찾아주렴	최근 독일축구 관련 기사	1
모노레일 타지마 되게 재미없어	모노레일 타기	0
최근 이 주일 간 받은 이메일 전부 보여라	최근 이 주일 간 받은 이메일 전부	1
안방문을 닫아라	안방문 닫기	1
비가 많이 오면 감전위험이 있다니까 조심해	감전 조심하기	1
에어컨 바람세기를 제일 세게 해주라	에어컨 바람세기 제일 세게 하기	1
내일 아침 브리핑에서 뵙겠습니다	내일 아침 브리핑에서 보기	1
내일 밤 예상 기온을 찾아라	내일 밤 예상 기온	1
식기건조기 자외선 살균 시작해 줄래	식기건조기 자외선 살균 시작하기	1
샤라포바의 방한 관련 기사 찾아	샤라포바 방한 관련 기사	1
여보 예물은 금광당에서 하죠	예물 금광당에서 하기	1
상관 하지마	상관하기	0
천정권의 호재는 팔고 바닥권의 악재는 사라	천정권의 호재는 팔고 바닥권의 악재는 사기	1
저녁 약속시간 수정해	저녁 약속시간 수정하기	1
소이 방 천정 보자	소이 방 천정 보이기	1
태풍 송다 관련 뉴스를 보여	태풍 송다 관련 뉴스	1
그럼 백화점 앞에서 기다리고 있어	백화점 앞에서 기다리기	1
소비자의 불만을 즉시 해결하십시오	소비자 불만 즉시 해결하기	1
구정 연휴에도 출근해야돼	구정 연휴 출근하기	1
너무 무리한 사업확장은 하지 마	무리한 사업확장하기	0
그와의 약속을 아무에게도 말하지 말아요	그와의 약속을 아무에게도 말하지 말기	0
몸이 찌뿌둥한데 찜질방 가서 풀자	찜질방 가서 몸 풀기	1
천천히 오세요 기다릴께요	천천히 오기	1
안방으로 가서 텔레비전 켜	안방 가서 텔레비전 켜기	1
야채를 많이 드세요 	야채 많이 먹기	1
니네 펜션에 사 인용 방 예약 좀 부탁해	펜션에 사 인용 방 예약하기	1
개근상장이라도 받아야지 학교 빠지지마	학교 빠지기	0
여의도까지 전철 타고 가는 게 가장 빠를 거 같은데 	여의도까지 전철 타고 가기	1
너무 욕심 부리지 말고 지금 팔아	지금 팔기	2
신혼여행 명소를 찾아라	신혼여행 명소	1
학교에 짐 정리 하러 가자	학교에 짐정리 하러 가기	1
내일 추울 거라니까 옷 많이 겹쳐 입고 나가	내일 옷 많이 겹쳐 입고 나가기	1
오빠 피곤하겠다 얼른 자	얼른 자기	1
약속의 중요성에 대해 아이들에게 설명해 주세요	약속의 중요성에 대해 아이들에게 설명하기	1
오늘 스케줄을 시간대별로 프린트해	오늘 스케줄 시간대별로 프린트하기	1
그래도 유명한 교수님이니깐 수업 열심히 들어	수업 열심히 듣기	1
올림픽 국가대표 축구 감독에 대한 기사를 알려	올림픽 국가대표 축구 감독 기사	1
기아 삼성의 선두 다툼에 관한 기사를 찾아줄래	기아 삼성 선두 다툼 기사	1
차도 막히는데 퀵서비스 이용해	퀵서비스 이용하기	1
서둘르자	서둘르기	1
그만해	그만하기	1
회의 끝나고 식사 함께 하죠	회의 끝나고 식사 함께 하기	1
약속을 할 때 신중히 생각했어야지 안 돼 꼭 나와	꼭 나오기	1
한산할 때 야외로 나가자	한산할 때 야외로 나가기	1
반야월역 앞에서 화요일 저녁 여섯시 반에 보자	반야월역 앞에서 호요일 저녁 여섯시 반에 보기	1
멀리 보고 살아 이 순간 어려운 일이라고 회피하지 말고	멀리 보고 살기	2
너무 좌절하지 마세요 곧 좋아지실 거예요	좌절하기	0
대문 잠가라	대문 잠그기	1
통장은 신분증하고 도장 가져와서 만드세요	통장 만들 때 신분증 도장 가져오기	1
주식회사에 담당자와 통화해보세요	주식회사 담당자와 통화하기	1
오늘은 선약이 있어서 힘들 것 같은데 다음주 월요일은 어때	다음주 월요일에 보기	1
기차는 이미 예매다 다 끝나 버렸으니 버스표를 알아 봐	버스표 알아보기	1
이동식 카메라 많으니깐 조심해	이동식 카메라 조심하기	1
모레 밤에 월드컵경기장역 오번 출구에서 보자	모레 밤에 월드컵경기장역 오번 출구에서 보기	1
미아리 금란교회 신축현장 포토뉴스를 보여라	미아리 금란교회 신축현장 포토뉴스	1
나 오늘 너무 외로우니까 모든 약속 취소하고 와 줄 수 있어	모든 약속 취소하고 와주기	1
내일 비가 올 확률을 말해줄래	내일 비가 올 확률	1
오븐 속에 뭐가 들어 있는지 보여주라	오븐 속에 든 것	1
남산 삼 호 터널은 원활한지 알려다오	남산 삼 호 터널 원활한지	1
주식을 할 때는 위험관리를 잘 하는 것이 중요해	주식할 때 위험관리 잘 하기	1
아무리 규율이라도 그럴 때는 융통성 있게 행동해	융통성 있게 행동하기	1
컴퓨터 앞에 누군지 보여줄래	컴퓨터 앞 사람	1
뭐든 적당히 하는 게 좋은 거야 너무 큰돈으로 시작 하지 마	너무 큰돈으로 시작하기	0
주식이 무조건 어렵다는 편견을 버려	주식이 무조건 어렵다는 편견을 버리기	1
온라인 주식 거래를 할 때는 개인정보 유출에 유의해야 해	온라인 주식거래를 할때 개인정보 유출에 유의하기	1
열쇠는 신발장에 넣어둬	열쇠 신발장에 넣어두기	1
비가 많이 오면 뒷산 때문에 위험하니까 지금 잘 살펴봐	지금 잘 살펴보기	1
같은 방향이면 같이 타고 가자	같이 타고 가기	1
독도를 새 화폐에 넣자고	독도 새 화폐에 넣기	1
좀 더 선선해지면 어디 교외로 놀러 갈까 	좀더 선선해지면 교외로 놀러가기	1
설계 도서를 협력업체에 보내세요	설계 도서를 협력업체에 보내기	1
사업계획서를 작성했는데 와서 좀 봐 줄래 	사업계획서 봐 주기	1
텔레비전 꺼주겠니	텔레비전 끄기	1
쉬는 시간에 잠깐 나와	쉬는 시간에 잠깐 나오기	1
티비를 켜주겠니	티비 켜기	1
날씨 좋은데 동물원 가자	동물원 가기	1
앞 차만 보고 적당 거리 유지하면서 달려	앞 차만 보고 적당 거리 유지하면서 달리기	1
어른 둘이요	어른 둘 주기	1
오늘 밤에 방화역 오번 출구에서 보자	오늘 밤 방화역 오번 출구에서 보기	1
너무 우울해 하지 마세요 	너무 우울해 하기	0
우유에다가 과일을 넣어서 한 번 먹어 봐	우유에다가 과일을 넣어서 먹기	1
지금 구로역인데 맨 앞 칸에서 타면 만날 수 있어 	맨 앞 칸에서 타기	1
정체 구간을 보여주련	정체 구간	1
관절의 유연성을 기르는 것이 중요해 	관절의 유연성 기르기	1
등록돼 있지 않으면 주식을 보유한 사람과 직접 거래해봐	주식을 보유한 사람과 직접 거래하기	1
뉴스도 좀 봐 정부정책이 중요하대잖아	뉴스 보기	1
귀사와 영원한 동반자가 되어 주기를 바랍니다	귀사와 영원한 동반자 되기	1
취직했다며 한 번 쏴라	한번 쏘기	1
홍제 램프 부근은 시시티브이로 찍은 정보도 볼 수 있는지 알려라	홍제 램프 부근은 시시티브이로 찍은 정보도 볼 수 있는지	1
주말에 미술관 옆 동물원에서 만나는 걸로 하자	주말에 미술관 옆 동물원에서 만나기	1
잔소리 하지마	잔소리하기	0
장기 거래 실태에 대한 기사를 보여라	장기 거래 실태 기사	1
비가 많이 와서 저지대는 침수에 유의하래	침수에 유의하기	1
친구와 함께 공부 모임을 만들자	친구와 함께 공부 모임 만들기	1
주식투자는 절대적 유연성이 필요해	주식투자 절대적 유연성 가지기	1
운전할 때 안전띠 매는 거 잊지 마	운전할 때 안전띠 매기	1
차트 모양에 너무 신경 쓰지 마 너 그러다가 병 걸리겠어	차트 모양에 신경쓰기	0
최경주 선수의 근황에 관련된 기사 찾으렴	최경주 선수 근황 관련 기사	1
각 세장씩 인쇄해 주세요	각 세장씩 인쇄하기	1
폐장하기 전에 스키장 한 번 더 가자	폐장하기 전에 스키장 가기	1
고아원에 위문공연을 갈 사람들을 모집합니다	고아원에 위문공연 가기	1
밤에 야식 먹지 않기로 약속 했어	야식 먹기	0
내일 춥다니까 옷 따뜻하게 입어	옷 따뜻하게 입기	1
경인 고속도로는 원활한지 보여다오	경인 고속도로 원활한지	1
졸업식에는 다들 사진 촬영만하고 가	졸업식에 사진 촬영만 하고 가기	1
아침에 동네 한바퀴 돌자	아침에 동네 한바퀴 돌기	1
우리학교 여섯 시부터 축제니까 다섯 시 반에 학교 앞에서 봐	다섯 시반에 학교 앞에서 보기	1
공부하고 나서 요점정리를 해 둬	공부하고 나서 요점정리하기	1
부산 대마도 간 훼리 예약취소	부산 대마도 간 훼리 예약 취소	1
상품 기획 하나 해 보겠어	상품 기획 하기	1
사진첩 대거 업데이트 어서 와서 구경하고 발자국 남기기 	사진첩 대거 업데이트 와서 구경하고 발자국 남기기	1
청계천이 그렇게 예쁘다더라 내일 가자	내일 청계천 가기	1
십 오일이 스승의 날입니다 은사님을 찾아 뵙시다	은사님 찾아뵙기	1
마주앙 오픈 여자 골프 소식 찾아줄래	마주앙 오픈 여자 골프 소식	1
동남아시아 시장 개척을 위해 노력합시다	동남아시아 시장 개척을 위해 노력하기	1
그 회사는 자산이 없어서 투자하기 위험해	그 회사 투자하기	0
절전모드 부탁해	절전모드하기	1
사무실의 가습기를 모두 틀어 주시기 바랍니다	사무실 가습기 모두 틀기	1
조금 더 와	조금 더 오기	1
들어가기 전에 먼저 귀중품을 꼭 챙기세요	들어가기 전에 귀중품 챙기기	1
요즘 카드 때문에 난리더라 너도 조심해	카드 조심하기	1
강의 자료 보내 준다더니 보내 주지도 않고 어떻게 된 거야 	강의 자료 보내주기	1
우회 통로를 알려드리오니 그 쪽으로 이동하세요	우회 통로로 이동하기	1
선물 꼭 잊지 말아 안사오면 미워할 거야	선물 잊기	0
집에 몇 사람이나 있는지 알려주련	집에 있는 사람 수	1
외출하고 돌아오면 손 발은 꼭 씻어야 해	손발 씻기	1
제휴카드의 할인혜택도 꼼꼼하게 따져보세요	제휴카드 할인혜택 꼼꼼하게 따져보기	1
저녁에는 오토바이 타면 위험해	저녁에 오토바이 타기	0
좋은 사례와 나쁜 사례 각각 하나씩 제출 해 주세요	좋은 사례와 나쁜 사례 각각 하나씩 제출하기	1
환율과 주가의 상관성을 잘 살펴	환율과 주가의 상관성 살피기	1
점심에 마르쉐 앞으로 와서 연락해	점심에 마르쉐 앞으로 와서 연락하기	1
곧 비 올 것 같다 일찍 들어와라	일찍 들어오기	1
그때까지 숙제 다 해 오기로 약속하자	그때까지 숙제 다 해 오기	1
오늘의 유머를 보여줄래	오늘의 유머	1
요요현상을 막으려면 꾸준히 운동하는 수밖에	꾸준히 운동하기	1
넌 여름 돼도 노출하면 안 되는 거 알지	노출하기	0
밤에는 무지 춥다니까 잠바 한개 씩 가져와	잠바 한 개씩 가져오기	1
김 대리님이 사업계획서 작성하라 셔요	사업계획서 작성하기	1
운동하고 나서는 꼭 샤워 하고 자고	운동하고 나서 샤워 하고 자기	1
지금 나 체육관에 가는 길인데 같이 가지 않을래	체육관 같이 가기	1
아무 약이나 먹지 말고 병원에 가봐	병원에 가보기	2
구월 삼일부터 구월 오일까지 날씨를 보여라	구월 삼일부터 구월 오일까지 날씨	1
보일러를 가동시켜라	보일러 가동시키기	1
연습해	연습하기	1
어젯밤 오전에 온 새 메일을 찾아라	어젯밤 오전에 온 새 메일	1
대리운전 불러	대리운전 부르기	1
벚꽃 피면 내 차 타고 여행가자	벚꽃 피면 내 차 타고 여행가기	1
부모님도 같이 뵙기로 했으니까 준비하고 와	준비하고 오기	1
네 업무 다 처리 했어요 빨리 끝내고 오세요 	빨리 끝내고 오기	1
캠퍼스에서 타고 다니게 전기 퀵보드나 살까 	전기 퀵보드 사기	1
너도 될 수 있으면 빨리와라	빨리 오기	1
피이에프가 성공하려면 인력 운용 면에서 전문성을 갖춰야지	인력 운용 면에서 전문성 갖추기	1
가스오븐 이백 오십 도로 십 분 간 세팅해	가스오븐 이백 오십 도로 십 분간 세팅하기	1
산책 삼아 학교 한바퀴 돌자	학교 한바퀴 돌기	1
교과서에서만 출제하신다는데 교과서 위주로 공부해	교과서 위주로 공부하기	1
수상스키 같이 배워볼까	수상스키 같이 배워보기	1
까쓰 밸브 잠궈주라	까쓰 밸브 잠그기	1
하이닉스반도체 주식 열주만 예약해 줄래	하이닉스반도체 주식 열주 예약하기	1
비자 신청해	비자 신청하기	1
됐어 넌 한강수영장이나 가버려	한강수영장 가기	1
그 시간대는 길이 잘 막히니까 좀 더 뒤에 와	그 시간대는 좀 더 뒤에 오기	1
내가 오후에 전화 할 테니까 전화 꺼 놓지 마	오후에 전화 꺼 놓기	0
아이보 우로 돌아 정지	우로 돌아 정지하기	1
횡단보도를 건너기 전에는 좌우를 살펴 주세요	횡단보도 건너기 전에 좌우 살피기	1
동창이 유급휴가 나왔으니 모두 가서 축하해주자	동창 유급휴가 축하해주기	1
소이 방 컴퓨터 화면 보여줄래	소이 방 컴퓨터 화면 보이기	1
실내에서 버너 사용 조심해 위험해	버너 사용 조심하기	1
먼저 요청 계획서를 보내 준다고 하더니 왜 소식이 없어 	요청계획서 보내주기	1
연예인들 많이 가는 미용실로 가는 거다	연예인들 많이 가는 미용실 가기	1
시사만화를 검색해	시사만화 검색하기	1
음식점 할인 쿠폰 있는데 같이 가자	음식점 같이 가기	1
말하기 싫으면 말하지마	말하기	0
영양제를 한 대 맞고 가세요	영양제 한 대 맞고 가기	1
누나 책상위에 핸드폰 있나 찾아라	책상위에 핸드폰 있는지	1
재활용품을 이용해서 만들어 보자	재활용품을 이용해 만들어 보기	1
가스가 누출되면 알려주렴	가스 누출되면 알려주기	1
이건 교수님께 여쭈어보자	이건 교수님게 여쭈어보기	1
우와 첫눈이다 이런 날 영화 어때	영화 보기	1
분야별 헤드라인 보이렴	분야별 헤드라인	1
신호등 깜빡일 땐 웬만하면 서 있지 마	신호등 깜빡일 때 서 있기	0
수학여행 뒤풀이 꼭 할 거지	수학여행 뒤풀이하기	1
비행기 예약시간을 한 시간 미뤄라	비행기 예약시간 한 시간 미루기	1
너 그 은행에 가서 은행장한테 확실히 물어봐야 해	그은행에 가서 은행장한테 확실히 묻기	1
신촌 현대백화점 앞에 여섯 시까지 모이세요	신총 현대백화점 앞에 여섯 시까지 모이기	1
우리 못 본지 꽤 오래 됐네 술 한 잔 해야지 	술한잔 하기	1
박찬호의 연봉 관련 기사 찾아다오	박찬호 연봉 관련 기사	1
내가 다니는 휘트니스 클럽에 다니자	내가 다니는 휘트니스 클럽 다니기	1
커피숍 가서 오랜만에 얼그레이 하고 케이크 먹을까	커피숍 가소 얼그레이 케이크 먹기	1
현관을 지키고 있어	현관 지키기	1
기다려 곧 갈께	기다리기	1
동부 고속도로 진입로 고통상황은 어떤지 파악해	동부 고속도로 진입로 고통상황	1
오늘은 그냥 푹 쉬자	오늘은 푹 쉬기	1
우리 정말 그러지 말자	그러지 말기	0
발신자 중 정보 메일 있는지 확인해주렴	발신자 중 정보 메일 여부	1
축하하네 친구 한 턱 쏴야겠는걸	한 턱 쏘기	1
문상을 위해서 열 시에 정문에서 봐요	열 시에 정문에서 보기	1
키카컵 청소년 축구대회 관련 소식 찾아줄래	키카컵 청소년 축구대회 관련 소식	1
소이 방에 십 분 뒤 알람 세 번 울려줄래	소이 방에 십 분 뒤 알람 세 번 울리주기	1
프로농구 시범 경기 관련 기사 찾아다오	프로농구 시범경기 관련 기사	1
대설주의보 내렸으니 농작물 피해 없도록 하세요	농작물 피해 없도록 하기	1
업무용 휴대폰을 찾아가시기 바랍니다	업무용 휴대폰 찾아가기	1
한국 프로야구 우승팀에 대해 찾아다오	한국 프로야구 우승팀	1
화장실 비데 켜 놔주겠니	화장실 비데 켜 놓기	1
직파법은 왜 이앙법에 비해 가뭄에 강한지 알고 싶습니다	직파법은 왜 이양법에 비해 가뭄에 강한지	1
상관 하지마	상관하기	0
피곤할텐데 기지개 한번 쭉 켜고 일해	기지개 한번 쭉 켜고 일하기	1
넌 경험이 없으니까 간접투자를 하도록 해	간접투자하기	1
주식에 대해서는 문외한이라 조언을 듣고 싶어	주식 조언 듣기	1
자기 직전에 음식 먹는 건 피해	자기 직전에 음식 먹기	0
아마추어로써 준비한 이번 공연 꼭 구경 와 줄 거지 	이번 공연 구경오기	1
유산소 운동을 즐기자	유산소 운동 즐기기	1
우리 그 유명한 횟집 가보자	유명한 횟집 가기	1
해외에서 계약하러 오니까 공항으로 마중을 가게	공항으로 마중가기	1
삐치지 마	삐치기	1
열쇠를 잃어버리신 분 찾아가세요	열쇠 잃어버렸으면 찾아가기	1
대구행으로 새마을호도 한 장 예약해	대구행 새마을호 한장 예약하기	1
너무 지나친 운동은 건강에 해로워	지나친 운동하기	0
여름 이유식은 무엇보다 영양면에 더욱 신경을 써야 한다	여름 이유식 영양면에 신경쓰기	1
다음주 수요일 우리 학교 축제해 다들 놀러와	다음주 수요일 우리 학교 축제 놀러오기	1
동생한테 가서 밥 먹으라고 말해	동생한테 가서 밥 먹으라고 말하기	1
하계 올림픽 유치 관련 기사 찾아주렴	하계 올림픽 유치 관련 기사	1
내일 춥데 옷 많이 껴입고 나가	내일 옷 많이 껴입고 나가기	1
오늘 롯데 팀 전적과 관련된 소식 보자	오늘 롯데 팀 전적 관련 소식	1
오늘 오후에 뵐 수 있을까요	오늘 오후에 보기	1
졸지마	졸기	0
지금 만날 수 없어	지금 만나기	1
이란 이라크전에 대한 기사를 찾아	이란 이라크전 기사	1
이번 주말엔 나이트 꼭 가기로 약속한 거다	주말에 나이트 가기	1
오늘 수업 한곳부터 예습해오세요	오늘 수업한 곳부터 예습해 오기	1
우리 만나서 같이 자전거 타자	만나서 같이 자전거 타기	1
갈비찜 해놓았으니 어서 들어와	어서 들어오기	1
그럼 약속시간을 조금 앞당기는 것이 좋겠다	약속시간 조금 앞당기기	1
청량리 텍사스 관련 기사를 찾아라	청량리 텍사스 관련 기사	1
오늘 밤까지 단어를 모두 외우기로 했던 거 기억해 	오늘 밤까지 단어 모두 외우기	1
전화주시면 정류장까지 나가겠습니다	전화주기	1
노트 좀 빌려주라 뒷부분을 못 적었어	노트 빌려주기	1
어제 전국 공항의 날씨를 찾아라	어제 전국 공항 날씨	1
레포트는 파워포인트로 작성 해야돼	레포트 파워포인트로 작성하기	1
교회 사기에 대한 기사를 찾아라	교회 사기 기사	1
내일은 단수조치되오니 미리 물을 받아 놓으시기 바랍니다	미리 물을 받아 놓기	1
냉장고 안에 잡채 데워먹어	냉장고 안에 잡채 데워먹기	1
고양이와 함께 거실에 가 있어라	고양이와 함께 거실에 가 있기	1
티비 음소거 시켜줄래	티비 음소거하기	1
자가용은 웬만하면 가져 오지 말도록 해	자가용 가져오기	0
유가 증산 관련 기사를 보이렴	유가 증산 관련 기사	1
나오기 싫으면 집에서 쉬어	집에서 쉬기	1
컴퓨터 고쳐주기로 해놓고 왜 연락이 없어	컴퓨터 고쳐주기	1
어머니와 저녁약속이 있으니까 너도 꼭 와야 해	어머니와 저녁약속 오기	1
우리 그때 갔던데 거기 가자	그때 갔던데 가기	1
작년 유행했던 화장품 관련 기사를 보여라	작년 유행했던 화장품 관련 기사	1
당뇨병 예방하기 위해서 음식 조절을 잘해야 해	음식 조절 잘하기	1
욘사마 관련 소식을 찾아라	욘사마 관련 소식	1
여자 조심해	여자 조심하기	1
그냥 외우려고 하지 말고 이해를 해	이해하기	2
골프장 근처 술집 예약해	골프장 근처 술집 예약하기	1
문이 잠겼는지 화면으로 보여라	문이 잠겼는지 화면으로 보이기	1
단체 연수 가능한 장소 섭외 해 봐	단체연수 가능한 장소 섭외하기	1
열시에 선풍기 꺼	열시에 선풍기 끄기	1
펀드들의 반응을 잘 살펴보고 와라	펀드들의 반응 잘 살펴보고 오기	1
오디오 음량을 티비와 연결해줄래	오디오 음량을 티비와 연락하기	1
서울에서 인천가는 국도 지금 막혔는지 알려주렴	서울에서 인천가는 국도 지금 막혔는지	1
건조한 겨울철엔 화재예방 등에 유의하시기 바람	화재예방 등에 유의하기	1
눈여겨볼 필요가 있어	눈여겨보기	1
한 달 뒤에 다시 만나기로 약속해요	한 달 뒤에 다시 만나기	1
조금만 기다려라	조금만 기다리기	1
텔레비전 꺼주겠니	텔레비전 끄기	1
한번만 그 운동을 해보도록 해봐	그 운동 해보기	1
고기만 드시면 안 좋아요	고기만 먹기	0
요즘 아침저녁으로 꽤 쌀쌀하더라 옷 두껍게 입고 다녀	옷 두껍게 입고 다니기	1
아침 저녁으로 꼭 약 먹어	아침 저녁으로 약 먹기	1
메시지 남겨	메시지 남기기	1
경인고속도로의 전용차선 상황은 어떤지 알려주련	경인고속도로 전용차선 상황	1
이번 건은 확실히 처리해 주십시오	이번 건 확실히 처리하기	1
현재 경상도의 풍랑 경보 현황을 알려줄래	현재 경상도 풍랑 경보 현황	1
카드 값 보내라	카드 값 보내기	1
내일 아침부터 공원 한바퀴 돌고 오자	내일 아침부터 공원 한바퀴 돌고 오기	1
예약 취소하면 환불이 되는지 알아볼래	예약 취소 환불 가능 여부	1
나 열쇠 빠뜨렸어 문 앞에서 기다려	문 앞에서 기다리기	1
섬유 쪽 주식을 한 번 사 보는 것도 좋을 거야	섬유 쪽 주식 사 보기	1
문상을 위해서 열 시에 정문에서 봐요	열 시에 정문에서 보기	1
그 외 업무는 다른 사람에게 맡겨	그 외 업무 다른 사람에게 맡기기	1
영수증 주실래요	영수증 주기	1
안방 텔레비전 사 번으로 돌려줄래	안방 텔레비전 사 번으로 돌리기	1
예약 확인되면 알려라	예약 확인되면 알리기	1
거래처 방문하고 계획서 받아 오세요	거래처 방문하고 계획서 받아 오기	1
정말 완벽하게 익힌 후에야 분석과 투자에 나서도록 해	완벽하게 익힌 후에 분석과 투자에 나서기	1
다음 신호등 받고 유턴	다음 신호등 받고 유턴하기	1
창동 주변의 찜질방 정보를 알려	창동 주변 찜질방 정보	1
만난 지 너무 오래 됐으니까 이번 주에 얼굴이라도 한 번 보자	이번 주에 얼굴 보기	1
주말에 집에 쳐 박혀 있지 말고 등산이나 가자	등산 가기	2
그러면 대중예술 재수강 같이 할래요	대중예술 재수강 같이 하기	1
우리 꼭 알바비 받아서 뷔페 가자	알바비 받아서 뷔페 가기	1
술 한잔 사줄꺼지	술 한잔 사주기	1
비행기 예약 좀 할래	비행기 예약하기	1
연예도 사업에 속한다 우리 사업하자 	사업하기	1
땀을 흘려야 살이 빠지지	땀 흘리기	1
지하철 마지막 운행시간을 알려	지하철 마지막 운행시간	1
그 서류 오늘까지 보내주시기로 했죠 	서류 오늘까지 보내기	1
시장 점유율을 늘리려면 우리 사업을 확장해야 합니다	우리 사업 확장하기	1
내일 약속 미뤄서 다음주에 만나면 안될까	내일 약속 미뤄 다음주에 만나기	1
야외로 다니면서 자연 공부를 해 보세요	야외로 다니면서 자연 공부하기	1
오늘 삼백일 호에서 모여 찾기 쉬울거야	오늘 삼백일 호에서 모이기	1
버티고개 교통상황은 어떤지 보여주라	버티고개 교통상황	1
옥주현 윙크 금지령 관련 기사 찾아라	옥주현 위크 금지령 관련 기사	1
우리 빨리 극적인 상봉을 하자꾸나	빨리 극적인 상봉하기	1
다음 주에 과 대항 축구 경기가 있으니 모두 응원 바랍니다	다음 주에 과 대항 축구 경기 응원하기	1
안전벨트 안 매다가 저승사자 찾아온다	안전벨트 매기	2
쉴 때 에너지 충전 많이 하세요	에너지 충전 많이 하기	1
산불발생의 위험이 높아 취식을 금지합니다	취식하기	0
압록강을 통한 탈북 소식을 검색해	압록강을 통한 탈북 소식	1
오늘 탁구 경기 관련 기사를 알려	오늘 탁구 경기 관련 기사	1
약 드세요	약 먹기	1
오해 하지마	오해하기	0
환율 떨어진다고 엄마가 해외 송금 좀 천천히 하래	해외 송금 천천히 하기	1
야간 학우 음악회 있으니 기량을 뽐내세요	야간 학우 음악회 기량 뽐내기	1
그 수영장은 샤워시설이 너무 좋대 우리도 거기 다니자	그 수영장 다니기	1
한번에 많은 이익을 남기려고 욕심 부리지 말아	한번에 많은 이익을 남기려고 욕심부리기	0
따뜻하게 챙겨 입어	따뜻하게 챙겨 입기	1
그래도 유명한 교수님이니깐 수업 열심히 들어	수업 열심히 듣기	1
사은회 생사가 개최되오니 참석 부탁 드립니다	사은회 생사 참석하기	1
텔레비전 입력을 외부입력으로 전환해	텔레비전 입력을 외부입력으로 전환하기	1
일곱시쯤 도착하니까 적당히 만나서 밥먹어요	일곱시쯤 만나 밥먹기	1
오빠가 병원에 자주 찾아가 봐요	병원에 자주 찾아가기	1
나한테 좋은 해법이 있으니깐 일단 와	일단 오기	1
출구가 하나이오니 혼잡을 막기 위해 줄을 서주십시오	줄 서기	1
그럼 아예 영화 여러 개 볼까 	영화 여러 개 보기	1
술 한잔 마시자	술 한잔 마시기	1
꼭 약속해줘 그 날 펑크 내지 않겠다고	그날 펑크내기	0
그 듣기는 귀를 기울여서 들어야 합니다	귀를 기울여서 듣기	1
티비 음소거 시켜라	티비 음소거시키기	1
내일 햇빛이 강하지 않다니까 수영장 가자	내일 수영장 가기	1
눈치 봐서 일하자 불똥 튄다	눈치봐서 일하기	1
빠지지마	빠지기	0
서울대 근처 도로 상황 표시를 보여주렴	서울대 근처 도로 상황 표시	1
뷔페 이용권이 생겼는데 같이 갈래 	뷔페 같이 가기	1
뷔페 예약하신 분은 자리로 오시기 바랍니다	뷔페 예약했으면 자리로 오기	1
작은방에 청소기 밀어줄래	작은방 청소기 밀어주기	1
집에 도착하면 전화해	집에 도착하면 전화하기	1
저녁 식사 같이 하실래요	저녁 식사 같이 하기	1
부산 지역 주요기사 보여줄래	부산 지역 주요기사	1
주가나 금리의 오르내림과 관계없이 운용전략을 꾸준히 유지할 것	주가나 금리의 오르내림과 관계없이 운용전략을 꾸준히 유지하기	1
촬영 끝나고 우리 초밥 먹으러 가자	촬영 끝나고 초밥 먹기	1
본선은 예선 통과곡으로 참여하세요	본선은 예선 통과곡으로 참여하기	1
홍길동 교수님 과목 시험 범위 좀 가르쳐 줄래	홍길동 교수님 과목 시험 범위	1
아이들이 흥미 있는 학습을 할 수 있도록 유도하세요	아이들이 흥미있는 학습을 할 수 있도록 유도하기	1
요번에 계획한 운동 시간을 변경해	요번에 계획한 운동 시간 변경하기	1
스팸 이메일함 삭제해줄래	스팸 이메일함 삭제하기	1
도시 고속도로 소통 상황을 알려라	도시 고속도로 소통 상황	1
오늘 고기뷔페 가자 실컷 먹고 싶어	오늘 고기뷔페 가기	1
양재역 주변에 아직도 공사하는지 알 수 있을까	양재역 주변 아직 공사하는지	1
저 빨강색 수영복을 사서 동해로 해수욕하러 가자	빨강색 수영복 사서 동해로 해수욕 가기	1
다음 해에 같이 학교 다니기로 해	다음 해에 같이 학교 다니기	1
지금 빨리 달러 사놔야 돼	지금 빨리 달러 사놓기	1
유상증자 공고가 났으니 바로 찾아 봐 	유상증자 공고 찾아보기	1
안전띠 안매면 큰일나	안전띠 매기	2
시디를 바꿔라	시디 바뿌기	1
오늘 더우니까 밖에서 너무 오래 있지 마	밖에서 오래 있기	0
뒤늦게 움직이는 주식에 주목하라	뒤늦게 움직이는 주식에 주목하기	1
오늘 프로야구 경기 현황 보여라	오늘 프로야구 경기 현황	1
어제 했던 예약을 확인해	어제 했던 예약 확인하기	1
수표 뒤에 이름과 주민 번호를 적어야지	수표 뒤에 이름과 주민 번호 적기	1
왜 전화 안해	전화하기	1
이왕 해야 되는 거면 마음 여유롭게 가지고 해	마음 여유롭게 가지고 하기	1
음주운전 하지마	음주운전하기	0
되도록 채소 위주로 먹여	되도록 채소 위주로 먹이기	1
올 여름 전국의 기압 배치도 보여라	올 여름 전국 기압 배치도	1
샤워기에서 따뜻한 물을 틀어	샤워기에서 따뜻한 물 틀기	1
인사부터 먼저 건넨 뒤에 식사를 하도록 하지	인사부터 먼저 건넨 뒤 식사하기	1
어젯밤 내가 성훈이에게 보낸 이메일 송신 확인해	어젯밤 성훈이에게 보낸 이메일 송신 확인하기	1
돌고래 쇼가 있으니 다들 모여주시기 바랍니다	모이기	1
특히 외국인 투자 추이를 파악해요	외국인 투자 추이 파악하기	1
십년 정도의 장기간 여윳돈이 있으면 선박펀드에 가입해	선박펀드 가입하기	1
주식을 하려면 꼭 여유자금을 가지고 하도록 해	여유자금 가지고 주식하기	1
우리 만나지 말자	만나기	0
백 미터 앞 좌회전 입니다	백 미터 앞 좌회전하기	1
핸드폰 사업 계획서 쓰세요	핸드폰 사업 계획서 쓰기	1
실업 배드민턴에 관한 기사를 찾아줄래	실업 배드민턴 관한 기사	1
수업 시간 빼먹는 것은 나쁜 행동이야	수업 시간 빼먹기	0
대북사업에 관련된 기사를 찾아	대북사업 관련 기사	1
외교통상부 장관에 대한 뉴스를 보여주렴	외교통상부 장관 뉴스	1
추가된 일정 확인해	추가된 일정 확인하기	1
오늘 바이어 오는데 통역할 사람 좀 알아봐	통역할 사람 알아보기	1
자네 사표 내고 그 쪽으로 가면 부정경쟁방지법 위반이야	사표 내고 그 쪽으로 가기	0
오늘 저녁에 외식한다고 너 빨리 들어오래	빨리 들어오기	1
이번 주말에 성당 가서 세례 받아	이번 주말 성당가서 세례받기	1
내일 저녁에 쇼핑 같이 하자	내일 저녁에 쇼핑 같이 하기	1
보일러를 급탕으로 해주라	보일러 급탕으로 하기	1
시간에 맞춰서 로그인해 주시기 바랍니다	시간에 맞춰서 로그인하기	1
네가 먼저 가서 있으면 내가 뒤따라 갈게	먼저 가서 있기	1
시크릿 카드 보안 철저히 해야 해	시크릿 카드 보안 철저히 하기	1
스팸 이메일함을 모두 비워줄래	스팸 이메일함 모두 비우기	1
이번 주 토요일 과외를 일요일로 미루자	이번 주 토요일 과외를 일요일로 미루기	1
어젯밤 송신 내용 중 세시 에서 다섯시 사이에 확인 이메일 보여라	어젯밤 송신 내용 중 세시에서 다섯시 사이 확인 이메일	1
간혹 혹하는 마음으로 하게 되는 경우가 있는데 그건 절대 안 돼	혹하는 마음으로 하기	0
최근 박찬호 경기 관련 기사 찾아	최근 박찬호 경기 관련 기사	1
부모님방 돌침대 온도 조절	부모님방 돌침대 온도 조절하기	1
리모콘의 위치를 찾아라	리모콘의 위치	1
회전을 멈춰 줄래	회전 멈추기	1
지리산 산악예보 보자	지리산 산악예보	1
타이거 우즈 경기 기사가 있는지 알려다오	타이거 우즈 경기 기사	1
음식을 골고루 드세요 편식은 안 좋아요	음식 골고루 먹기	1
이런 날씨에 운동하다간 더위 먹어	운동하기	0
학교 빠지지마	학교 빠지기	0
내일 오전 열 시까지 이십팔 동 앞으로 물리화학 책 갖고 와	내일 오전 열 시까지 이십팔 동 앞으로 물리화학 책 갖고오기	1
오늘 약속 다 취소해	오늘 약속 다 취소하기	1
버스표도 구해 놓는 게 좋겠다	버스표 구해 놓기	1
오빠 성의를 봐서라도 쫌 봐주라	봐주기	1
현재 풍랑 주의보 해제 지역을 보여	현재 풍랑 주의보 해제 지역	1
뒷골목 쪽이 더 멋지니까 그리로 가자	뒷골목 쪽으로 가기	1
다음달 아침 운동계획 보여	다음달 아침 운동계획	1
이치로 선수의 홈런 기사 알려	이치로 선수의 홈런 기사	1
국내 바이오 단지와 관련된 기사 모아줄래	국내 바이오 단지 관련 기사	1
다음 카페에 공지사항 올렸으니 모두 보도록	다음 카페 공지사항 보기	1
정기적으로 혈당 및 요당 검사를 받아 보는 건 어떨까	정기적으로 혈당 및 요당 검사 받기	1
내일 춥데 옷 따뜻하게 입고 나가	내일 옷 따뜻하게 입고 나가기	1
재즈댄스를 배우면 균형 잡힌 몸매가 된다는데 같이 해볼까 	재즈댄스 같이 배우기	1
이번 주 금요일에 워크숍 있으니깐 잊지 마시기 바랍니다	이번 주 금요일 워크숍 오기	1
이퀼라이져를 팝 모드로 바꿔주라	이퀼라이져를 팝 모드로 바꾸기	1
올해 케이비에스공채에 대해 보여줄래	올해 케이비에스공채	1
추우니까 옷 두껍게 입고 나가	옷 두껍게 입고 나가기	1
해외 진출을 위한 아이디어를 내 주십시오	해외 진출 위한 아이디어 내기	1
주식으로 돈 좀 벌었다며 근사하게 한턱 쏴라	한턱 쏘기	1
모레 서울행으로 어린이 세 좌석 예약해놔	모레 서울행 어린이 세 좌석 예약하기	1
흐름이 너무 불규칙한 소형주도 관심을 두지 않는 게 좋아	흐름이 너무 불규칙한 소형주 관심두기	0
너의 일에 대해서 항상 공부하지 않으면 뒤쳐지게 돼	일에 대해서 항상 공부하기	1
샌드위치는 삼단으로 만들자	샌드위치 삼다으로 만들기	1
포인트 제목 있는 메일을 보이렴	포인트 제목 있는 메일	1
식기 세척기 작동해다오	식기 세척기 작동하기	1
더운데 더위 먹지말고 집에 일찍 들어가	집에 일찍 들어가기	2
마일리지를 이용해서 가려면 미리 예약해야 해	미리 예약하기	1
거기 서라	거기 서기	1
적당한 운동은 감기예방에 그만 운동하시오	운동하기	1
시월 팔일 체육 대회 있으니까 준비해	시월 팔일 체육대회 준비하기	1
종로 교차로 교통상황을 보자	종로 교차로 교통상황	1
국회의원 선거에 모두들 참여해주시기 바랍니다	국회의원 선거 참여하기	1
유럽 챔피언스리그에 관한 소식 찾아라	유럽 챔피언스리그 소식	1
아기 예방주사는 시기 맞춰서 접종하세요	아기 예방주사 시기 맞춰서 접종하기	1
일어났냐 늦지 않게 서둘러	서두르기	1
피부과 약이 특히 독하니까 밥 많이 먹고 먹어야 한데	피부과 약 밥 많이 먹고 먹기	1
우리가 힘을 합쳐 꼭 그를 뭉개자	힘을 합쳐 그를 뭉개기	1
몸두 허한데 삼계탕 먹으러 가자	삼계탕 먹으러 가기	1
친구들과의 계모임 날짜를 알아보렴	친구들과의 계모임 날짜	1
빌려주기로 한 음반 내일 꼭 가져와	빌려주기로 한 음반 내일 가져오기	1
수요일에 보기로 한 것 잊지 마	수요일에 보기	1
심야버스가 있으니까 두 시까지 신나게 놀자	두시까지 놀기	1
아테네 장애인 올림픽 개막일 관련 기사 검색	아테네 장애인 올림픽 개막일 관련 기사	1
사랑하는 우리 남편 어깨 펴고 힘내세요	어깨 펴고 힘내기	1
크리스마스 때 영화나 보러 가자	크리스마스 때 영화 보러 가기	1
규정 속도를 꼭 준수하도록 해	규정 속도 준수하기	1
이번달 중순 지나야 한가해질 것 같아 그 때 보자	이번달 중순 지나 보기	1
삼성 자동차 부실에 대한 소식을 찾아라	삼성 자동차 부실 소식 찾기	1
자료 준비가 철저하게 이뤄져야지	자료 준비 철저하게 하기	1
임의 매매로 손해를 봤다면 증거를 먼저 확보 해 둬	증거 먼저 확보해 두기	1
차에 초보 운전이라고 써 붙이고 나가	차에 초보 운전이라고 써 붙이고 나가기	1
나 이따 나갈 때 네 양산 빌려줘 	양산 빌려주기	1
봄이라고 방심하지 말고 따뜻하게 입고 다녀 아직 춥다	따듯하게 입고 다니기	2
좀 더 생각해보고 내일 오전에 회의를 다시 열죠	좀 더 생각해보고 내일 오전 회의 다시 열기	1
사업터전 뿌리 내리십시오	사업터전 뿌리 내리기	1
현재 서울시내 교통 원활한 곳을 보여주렴	현재 서울시내 교통 원활한 곳	1
뼈가 튼튼해지려면 칼슘 섭취해	칼슘 섭취하기	1
신행정수도 건설 관련 기사 검색해	신행정수도 건설 관련 기사	1
미역을 많이 드세요	미역 많이 먹기	1
연휴 기간 조심해서 운전해	조심해서 운전하기	1
술 그만 마셔 위에 병 난다	술 마시기	0
이번 하반기 채용 관련 기사 검색해	이번 하반기 채용 관련 기사	1
오늘은 그냥 푹 쉬자	푹 쉬기	1
환율은 그때 그 때 변하니까 꼼꼼하게 챙겨봐	환율 꼼꼼하게 챙겨보기	1
망년회 때문에 몸 버리겠다 세 번 이상은 가지 말자	망년회 세 번 이상 가기	0
웬만하면 내려오지	내려오기	1
십 년 뒤에도 애인 없으면 우리끼리 결혼하자	십 년 뒤에도 애인 없으면 우리끼리 결혼하기	1
이십일 즈음하여 여행 어때요	이십일 즈음 여행하기	1
아홉시로 꺼짐 예약을 해	아홉시로 꺼짐 예약하기	1
니가 신입인 만큼 회사의 분위기 메이커가 되라	회사의 분위기 메이커가 되기	1
요즘 임용 준비로 많이 바쁘다면서 가끔은 쉬어가면서 해	쉬어가면서 하기	1
운동하고 싶으면 먼저 일찍 일어나 봐	운동하고 싶으면 먼저 일찍 일어나기	1
산성비 맞지 않도록 주의해	산성비 주의하기	1
전시회 오프닝 다섯 시 부터야 잊지 말고 꽃 사와라	전시회 오프닝 꽃 사오기	1
지하 일 층에 있는 회의실에서 모이는 걸로 합시다	지하 일 층 회의실에서 모이기	1
방금 전 채널로 바꿔줄래	방금 전 채널로 바꾸기	1
조간 신문 왔는지 화면을 좀 보여	조간 신문 왔는지	1
고속버스 우등 타 의자가 훨씬 편해	고속버스 우등 타기	1
어제 수신 내용 중 두시 에서 네시 사이에 확인한 메일 보여주렴	어제 수신 내용 중 두시에서 네시 사이 확인한 메일	1
어젯밤 새 메일 중 아이디 토니가 보낸 이메일 찾아라	어젯밤 새 메일 중 아이디 토니가 보낸 이메일	1
스페인에 진출한 이천수 관련 기사를 모아다오	스페인 진출한 이천수 관련 기사	1
내년에 해외 출장가는 사람들을 모두 보여라	내년 해외 출장가는 사람들 모두 보이기	1
박지성의 부상 관련 기사 찾아주렴	박지성 부상 관련 기사	1
너 이리로 좀 와라	이리로 오기	1
찬물로 세탁해줄래	찬물로 세탁하기	1
전자렌지를 작동시켜줄래	전자렌지 작동시키기	1
넘쳐나는 목사 생산에 대한 기사를 찾아라	넘쳐나는 목사 생산에 대한 기사	1
내일 떡볶이 사줘야 나도 김밥 사줄 거야	내일 떡볶이 사주기	1
통장과 인감도장 보관을 잘 하시길 바랍니다	통장과 인감도장 보관 잘 하기	1
졸업식 끝나고 이따 뒷풀이 때 봬요	뒷풀이 때 보기	1
무균무때 관련 광고를 보여라	무균무때 관련 광고	1
여의도 빌딩 앞에서 일곱 시에 먼저 밥 먹고 있을테니 찾아와	여의도 빌딩 앞 일곱 시에 찾아오기	1
그러지마	그러기	0
아기 침대 취소해	아기 침대 취소하기	1
졸지말고 운전해	운전하기	2
오늘 약속 잊으면 안돼 다음에 다른 말하기 없기	오늘 약속 잊기	0
방안에 있는 책들 전부 가져오래	방안에 있는 책들 전부 가져오기	1
이따가 자취방에서 쓸 책상을 사는데 같이 가자	자취방에서 쓸 책상 사는데 같이 가기	1
선거는 내일 부터야 참여하기 바래	선거 내일부터 참여하기	1
요번에는 어디든 들어가	요번에는 어디든 들어가기	1
영희야 배당보고 투자하면 절대로 안 돼	배당보고 투자하기	0
넘쳐나는 음식 쓰레기에 대한 기사를 검색해	넘쳐나는 음식 쓰레기 기사	1
추운 날씨에는 최대한 몸을 풀어주시고 몸을 따뜻하게 해주세요	최대한 몸을 풀고 따뜻하게 해주기	1
다른 길로 와라	다른 길로 오기	1
가입하시기 전에 자신에 대하여 알림 말을 적어 주세요	가입 전에 자신에 대한 알림말 적기	1
차라리 차 가지고 교외로 나가자 	차 가지고 교외로 나가기	1
부천 대 삼성의 경기에 관한 기사 모아볼래	부천 대 삼성 경기 기사	1
휴면기의 주식은 손대지 마라	휴면기 주식 손대기	0
캘리포니아 와인 전문점 좀 추천해주실 수 있어요	캘리포니아 와인 전문점 추천하기	1
비데 무브 기능 작동해	비데 무브 기능 작동하기	1
쉴 때 에너지 충전 많이 하세요	쉴 때 에너지 충전 많이 하기	1
수요일에 오랜만에 데이트 하자 	수요일에 데이트 하기	1
일기예보 보고 나서 휴가 기간 정하자	일기예보 보고 나서 휴가 기간 정하기	1
현관에 불을 켜놔줄래	현관 불 켜기	1
자전거 탈까	자전거 타기	1
오늘 점심 때 로비에서 십분 일찍 봐요	오늘 점심 때 로비에서 십분 일찍 보기	1
야 언제 한번 만나 한 잔 빨자	한번 만나 한잔 빨기	1
철수야 교수님께서 부르신다	교수님께 가기	1
창문을 잠궈줄래	창문 잠그기	1
해외증시의 움직임이 반드시 포함되어야 해	해외증시의 움직임 포함하기	1
육류보다 채소류를 많이 먹어야 좋아 	육류보다 채소류 많이 먹기	1
유통 기한을 확인 하여 주시길 바랍니다	유통기한 확인하기	1
서류를 한번보고싶습니다	서류	1
서재에 불은 다 꺼졌는지 좀 확인해	서재에 불 다 꺼졌는지	1
너의 당당한 포부를 만천하에 알려	당당한 포부를 만천하에 알리기	1
동생 귀국하는 날이야 퇴근하고 바로 와	퇴근하고 바로 오기	1
우리 방향 같으니까 갈 때 같이 택시 타고 가자	갈 때 같이 택시 타고 가기	1
그냥 차 타고 쭉 내려와 신호등 앞에 있을게	차 타고 쭉 내려오기	1
게임방 갈까	게임방 가기	1
헹굼 세 번 해줄래	헹굼 세 번 해주기	1
저쪽으로 가 있어라	저쪽으로 가 있기	1
이틀이요	이틀 주기	1
주말에 시간 있으면 야외로 나갈까	주말에 시간 있으면 야외로 나가기	1
기상 특보 발령 지역의 지도 보여줄래	기상 특보 발령 지역 지도	1
오늘 저녁 열시 케이비에스에서 불멸의 이순신 녹화해	오늘 저녁 열시 케이비에스에서 불멸의 이순신 녹화하기	1
이남자가 사는법 란을 보여라	이남자가 사는법 란	1
은행에서 번호표 뽑고 있어	은행에서 번호표 뽑기	1
추워 무지 추워 치마 입지 마 다리 동상 걸린다	치마 입기	0
보고서 제출 날짜와 시간을 맞춰주시기 바랍니다	보고서 제출 날짜와 시간 맞추기	1
열세시에 작동을 하게 해주련	열세시에 작동하게 하기	1
뼈가 튼튼해지려면 칼슘과 철분이 들어간 음식을 많이 먹어	칼슘과 철분이 들어간 음식 많이 먹기	1
스테레오 모드로 해주겠니	스테레오 모드로 하기	1
정보처리 실습 꼭 들어야 되요	정보처리 실습 듣기	1
요번 토요일에 사육장 청소 부탁 드립니다	요번 토요일에 사육장 청소하기	1
새 편지 중 입금 확인 메일 확인해주렴	새 편지 중 입금 확인 메일 여부	1
첫째 이메일 열어	첫째 이메일 열기	1
이번 달 내가 부산갔던 일정 모두 보여라	이번 달 내가 부산갔던 일정 모두	1
나랑 내일 백화점에 쇼핑하러 같이 갈래	내일 백화점에 같이 가기	1
김해로 가는 새마을호 한 장 예약해	김해로 가는 새마을호 한장 예약하기	1
도리도리 한번 해볼래	도리도리하기	1
빨리 와 기다릴께	빨리 오기	1
십분내로 출발해	십분내로 출발하기	1
졸음운전만큼 위험한 게 없어	졸음운전하기	0
고기뷔페 같은 천국으로 가자	고기뷔페 같은 천국으로 가기	1
라디오 방송사고에 대한 기사를 보여줄래	라디오 방송사고 기사	1
거긴 우회전 안되니까 뒷길로 와	뒷길로 오기	1
대부분 잃는 것도 개인 투자자고 위험해 혼자는	혼자 투자하기	0
현관문 락을 잠궈라	현관문 락 잠그기	1
이번 주 일정 중 회식일정을 추가해	이번 주 일정 중 회식일정 추가하기	1
디브이디가 고장 났는데 서비스 쎈타에 전화해주련	서비스 쎈타에 전화하기	1
서재 온도 좀 높여주렴	서재 온도 높여주기	1
다시 주식 물량을 늘리는 것은 매우 위험한 일이지요	다시 주식 물량 늘리기	0
전화 끊으시면 저한테 연락주세요	전화 끊으면 연락 주기	1
수유역 사번 출구로 나오셔서 마을버스를 타고 오세요	수유역 사번 출구로 나와 마을버스 타고 오기	1
시장분위기에 휩쓸린 충동 매매는 금물이다	시장분위기에 휩쓸린 충동 매매하기	0
야 모든 작동을 좀 멈춰 줄래	모든 작동을 멈추기	1
교통 법규 위반 하지 마	교통 법규 위반하기	0
자가진단 실시해	자가진단 실시하기	1
부산의 영화제 여행을 예약해	부산의 영화제 여행 예약하기	1
술 많이 먹으면 위장 다 버려	술 많이 먹기	0
축구 하다가 다쳐서 그러니깐 병원으로 곧장 와	병원으로 곧장 오기	1
경부 고속도로 상행선 정체구간 알려	경부 고속도로 상행성 정체구간	1
눈 밭에서 너와 함께 뒹굴고 싶어	눈밭에서 함께 뒹굴기	1
서울 천안 간 정체 구간을 보여주련	서울 천안 간 정체 구간	1
대구로 새마을호 한 장 예약해	대구로 새마을호 한 장 예약하기	1
조금만 기다려 차가 밀려서 그래 곧 도착할 거야	조금만 기다리기	1
밥이 보약이야 꼭 챙겨먹어	밥 챙겨먹기	1
세달 정도만 꾸준히 하면 눈에 띄게 달라질 거야	세달 정도 꾸준히 하기	1
친구야 밥 사라 너 시험 잘 쳤다며	밥 사기	1
가스 꺼져있는지 확인해	가스 꺼져있는지	1
윗사람을 보면 인사를 해야 한다	윗사람 보면 인사하기	1
주식을 한탕주의로 생각하신다면 포기하세요	주식을 한탕주의로 생각하기	0
모레 아침에 내려 오는 비행기 예약하렴	모레 아침에 내려오는 비행기 예약하기	1
슬로우 쿠커 한 시간 뒤에 꺼	슬로우 쿠커 한 시간 뒤에 끄기	1
카드 만드는 것 영화 예매 할인 많이 되는 거 해	영화 예매 할인 많이 되는 카드 만들기	1
호법 분기점의 교통 흐름을 보여줄래	호법 분기점 교통 흐름	1
물 온도를 삼십 팔 도에 맞춰주련	물 온도를 삼십 팔도에 맞추기	1
외우는 게 아니라 이해해야 해	이해하기	2
이십오일 모임이야 꼭 나와야 돼	이십오일 모임 나오기	1
컴퓨터 이따가 와서 좀 봐주라	이따가 컴퓨터 좀 봐주기	1
오늘 같이 스쿼시나 하러 갈까 	오늘 같이 스쿼시 하러 가기	1
창문 옆 좌석을 주셨으면 합니다	창문 옆 좌석 주기	1
봄 내음이 완연한데 같이 사진 찍으러 가자	같이 사진 찍으러 가기	1
전자레인지를 전원을 확인해 줄래	전자레인지 전원 확인하기	1
교육학 과목 한 번 들어보지 그러니	교육학 과목 들어보기	1
운동장이나 몇 바퀴돌자	운동장 몇 바퀴 돌기	1
자기야 나 몸이 안 좋으니까 오늘 약속은 미루자	약속 미루기	1
전화기는 제 자리에 있는지 보여다오	전화기 제 자리에 있는지	1
뭐하고 지내냐 학원 다시 나와 선생님이 걱정하시잖아	학원 다시 나오기	1
라이딩이나 같이 뛸까나	라이딩 같이 뛰기	1
엄마에게 반짇고리를 가져다 드려	엄마에게 반짇고리 가져다 드리기	1
자동차 쇼 한다던데 보러 갈까 	자동차 쇼 보러가기	1
날이 이렇게 좋은데 주말에 야외 나가요	주말에 야외 나가기	1
탁구 프로 투어 랭킹에 관한 기사를 찾아줄래	탁구 프로 투어 랭킹 관한 기사	1
잊지마	잊기	0
외곽순환 도로 상황을 보여주렴	외곽순환도로 상황	1
전자금융거래와 계좌 비밀번호를 다르게 사용해	전자금융거래 계좌 비밀번호 다르게 사용하기	1
과속은 금물이야 천천히 와	과속하기	0
내일까지 서류 마무리 짓도록 해	내일까지 서류 마무리 짓기	1
구리의 정체구간을 알자	구리의 정체구간	1
극장에서는 외부 음식물을 삼가 주시기 바랍니다	극장에서 외부 음식물 먹기	0
포토샵 같은 것으로 작업하실 수 있으신 분 있으면 같이 해요	포토샵 작업 가능하면 같이 하기	1
안방 선풍기 취침모드 할래	안방 선풍기 취침모드 하기	1
이번 주 화요일에 제사 가는거 기록해	이번 주 화요일에 제사 가는거 기록하기	1
현관 불 켜줄래	현관 불 켜주기	1
어제 수신 내용 중 두시 에서 네시 사이에 확인 메일 보여줄래	어제 수신 내용 중 두시 에서 네시 사이 확인 메일	1
전화 하지	전화하기	1
오 분 뒤 버스가 출발하니 서둘러 탑승하시길 바랍니다	버스 서둘러 탑승하기	1
상승을 주도하는 업종과 테마를 찾아라	상승을 주도하는 업종과 테마 찾기	1
은행에서 원하는 서류를 챙겨오세요	은행에서 원하는 서류 챙겨오기	1
있는 돈 몽땅 투자하지 말고 여윳돈으로 투자해	여윳돈으로 투자하기	2
시험 예상 문제 같이 뽑아볼까	시험 예상 문제 같이 뽑기	1
규칙적인 식습관을 가지도록 해	규칙적인 식습관 가지기	1
매주 월요일 아침엔 본인 자리를 청소해 주시기 바랍니다	매주 월요일 아침엔 본인 자리 청소하기	1
추운데 등산가면 야 뇌졸중으로 쓰러져 조심해	추운데 등산가기	0
어젯밤 온 이메일 다 지워줄래	어젯밤 온 이메일 다 지우기	1
친구야 연락 좀 하고 살자	연락 좀 하고 살기	1
빨리 안 일어나면 뽀뽀할거야	빨리 일어나기	1
레저 중 다칠 경우를 대비해서 상해 보험에 가입해 둬	상해 보험에 가입해 두기	1
라디오 구십 오 점 구 헤르츠로	라디오 구십 오 점 구 헤르츠로 하기	1
요즘엔 콩이 유행이던데 콩을 한번 먹어봐	콩 먹기	1
연수기를 가동시켜주련	연수기 가동시키기	1
약속 어긴 사람이 소원 들어 주기다 	약속 어긴 사람이 소원 들어주기	1
티비 에스비에스로 바꿔다오	티비 에스비에스로 바꾸기	1
은진이 유학 간데 그전에 모이자	은진이 유학 전에 모이기	1
주유소에서 기름 넣어야 하니까 거기서 봐	주유소에서 보기	1
모범택시 타고 갈 테니까 돈은 네가 내	돈 내기	1
혼자서 공부하기 힘들면 과외 선생님을 구해	과외 선생님 구하기	1
다섯 정거장만 가면 되요 사 번 출구에서 기다려요	사 번 출구에서 기다리기	1
안돼	하기	0
너는 확정 금리로 바꿔 타는 게 유리해	확정 금리로 바꿔 타기	1
오늘 오전에 도착한 메일 모두 보여	오늘 오전에 도착한 메일 모두	1
우리 동네 주유소는 다른 곳보다 싸니까 거길 이용해	우리 동네 주유소 이용하기	1
오늘 오전 미팅이 취소 됐대 천천히 와	천천히 오기	1
대학 학점 교류가 늘던데 너도 신청 한 번 해 보던가	대학 학점교류 신청하기	1
적조 현상에 대한 기사를 찾아라	적조 현상 기사	1
창사 기념일의 행사를 기획 해 보게	창사 기념일의 행사 기획하기	1
거기서 춘천 방면으로 빠져야 돼요	거기서 춘천 방면으로 빠지기	1
위대한 사업가들을 배울 필요가 있어	위대한 사업가들 배우기	1
쇼핑하려고 하니깐 이따 저녁에 꼭 나와서 연락해	저녁에 나와서 연락하기	1
너 이번에도 늦으면 절교야 알았지 	늦기	0
거실로 가	거실로 가기	1
영화 시사회 표가 두장 생겼는데 나랑 같이 보러 가지 않을래 	영화 시사회 같이 보러가기	1
일간 스포츠의 아색기가를 보여라	일간 스포츠 아색기가	1
방금 기록된 리스트를 좀 띄워	방금 기록된 리스트	1
우리 그럼 몇 년 뒤에 만나는 거야	몇 년 뒤에 만나기	1
지금 만든 메일 지우고 새로 작성해	지금 만든 메일 지우고 새로 작성하기	1
얼굴이 많이 야위었던데 힘내고 밥도 잘 챙겨먹어	힘내고 밥도 잘 챙겨먹기	1
부품 사업을 확대 합시다	부품 사업 확대하기	1
김초롱 어제 경기 관련 기사 찾아주렴	김초롱 어제 경기 관련 기사	1
아예 지키지 못할 약속은 입도 뻥긋 하지 말아라	지키지 못할 약속은 입도 뻥끗 하기	0
길을 건널 때는 항상 좌우를 살펴라	길을 건널 때 좌우 살피기	1
현금 영수증 잘 챙겨둬 나중에 큰 혜택을 받을 수 있대	현금 영수증 잘 챙겨두기	1
보관함에 있는 이메일 제목 중 케이티가 포함된 이메일을 삭제 해줄래	보관함에 있는 이메일 제목 중 케이티가 포함된 이메일 삭제하기	1
내일 내차 쉬는 날이거든 그러니 카풀 좀 부탁하자	내일 카풀하기	1
엠비시로 채널 바꿔주련	엠비시로 채널 바꾸기	1
남들 이야기에 너무 귀 기울이지 말고	남들 이야기에 너무 귀기울이기	0
실기실 앞에서 보자 나 거기 옆 건물에서 수업이거든	실기실 앞에서 보기	1
이번 건은 확실히 처리해 주십시오	이번 건 확실히 처리하기	1
같이 시간표 짜서 수강신청하지 않을래 	같이 수강신청하기	1
연극 공연 티켓 예매확인을 부탁드립니다	연극 공연 티켓 예매확인하기	1
걔 돈 빌려주지 마 잘 안 갚는 애야	걔 돈 빌려주기	0
열시 이십분 미국가는 비행기를 예약해	열시 이십분 미국가는 비행기 예약하기	1
여기서 대전까지는 정체 구간인지 파악해주련	여기서 대전까지 정체구간인지	1
내가 예상보다 빨리 도착했으니 서둘러 주세요	서둘러 주기	1
분산투자를 해야 위험성이 적지	분산투자하기	1
죄송하지만 다음에 만나면 안 될까요	다음에 만나기	1
쿵푸허슬 오늘 저녁에 안 볼래	쿵푸허슬 오늘 저녁에 보기	1
금연 금주 하자	금연 금주하기	1
오늘 데이트 약속 있는데 이쁘게 입고 가야지	이쁘게 입고 나가기	1
구백십팔 동 앞에서 다섯 시에 보자	구백십팔 동 앞에서 다섯 시에 보기	1
골프 치러 갈까	골프 치러 가기	1
피자 시켜놓은 거 식탁에 있으니 데워 먹거라	피자 데워 먹기	1
꾸준한 연구와 끈질긴 노력이 필요합니다	꾸준한 연구와 끈질긴 노력 하기	1
익지 않은 음식을 드시면 위험 합니다	익지 않은 음식 먹기	0
맞기 싫으면 내 말대로 해	내 말대로 하기	1
성수역에서 이호선 지선으로 바꿔 타시면 됩니다	성수역에서 이호선 지선으로 바꿔타기	1
김포공항 진입로가 막히는지 알려주렴	김포공항 진입로 막히는지	1
오늘의 운세를 보여라	오늘의 운세	1
나 시사회 당첨됐는데 같이 가자	시사회 같이 가기	1
네가 좋다고 추천해준 한의원 전화번호 좀 다시 가르쳐 줄래 	좋다고 추천해준 한의원 전화번호	1
시험 끝나고 영화 한편 보자	시험 끝나고 영화 한편 보기	1
계좌번호랑 수취인명이 일치하지 않네요 확인 부탁드려요	계좌번호 수취인명 확인하기	1
모의투자 시스템으로 주식투자를 연습해보세요	모의투자 시스템으로 주식투자 연습하기	1
저기 가서 할머니 방 찍어와	저기 가서 할머니 방 찍어오기	1
내일부터 술도 줄이세요 약속해요	내일부터 술 줄이기	1
김치냉장고의 오른쪽 칸의 온도를 일 도 올려줄래	김치냉장고의 오른쪽 칸 온도 일 도 올리기	1
밤에 먹는 야식은 속 다 버려	밤에 야식 먹기	0
금리 변화 관련 뉴스를 보여라	금리 변화 관련 뉴스	1
걱정 하지마	걱정하기	0
오늘같이 추운 날은 모두 따뜻하게 입고가세요	따뜻하게 입고가기	1
비가 오는 날에 빨래를 하면 어떻게 하냐	비가 오는 날 빨래하기	0
주차하실 때는 주차요원의 안내를 받으세요	주차요원의 안내 받기	1
인터넷 금융 사기의 유형들을 연구하자	인터넷 금융 사기의 유형들 연구하기	1
반신욕 후에 잠시 누워 있는 것도 좋아	반신욕 후에 잠시 누워있기	1
안방 화장실 욕조 수도꼭지 보여주렴	안방 화장실 욕조 수도꼭지	1
샌드위치 싸서 산책 나가	샌드위치 싸서 산책 나가기	1
선급 비용에 대해서 회계 처리해	선급 배용에 대해 회계 처리하기	1
롯데 자이언츠의 대진표 관련 기사 보여주렴	롯데 자이언츠 대진표 관련 기사	1
책상 위에 네가 말한 서류 올려놨어 가져가	책상 위에 서류 가져가기	1
만취자는 출입이 불가능 합니다	만취자 출입하기	0
이번에 투표하십시오	이번에 투표하기	1
바람 많이 불더라 외투 꺼내 입어	외투 꺼내 입기	1
벼락이 치고 있으니 쇠붙이 가까이 가지 마십시오	쇠붙이 가까이 가기	0
오분 빨리 가려다 큰 사고 나니까 속도 줄이자	속도 줄이기	1
영화표가 생겼는데 같이 보러갈래	영화 같이 보러가기	1
새터 비용이 예상했던 것보다 조금 올랐으니 확인해 주세요	새터 비용 확인하기	1
유럽 챔피언스리그에 관련된 기사를 보여주련	유럽 챔피언스리그 관련 기사	1
소이 방 에어컨 이십 오 도 맞춰줄래	소이 방 에어컨 이십 오 도 맞춰주기	1
우리 만나서 영화 보러 가자	만나서 영화 보러 가기	1
장애인 올림픽 성적 좀 보여다오	장애인 올림픽 성적	1
포토샵 같은 것으로 작업하실 수 있으신 분 있으면 같이 해요	포토샵 작업 가능하면 같이 하기	1
다음주까지 샘플 좀 볼 수 있을까요	다음주까지 샘플 보기	1
실험 보고서 늦어도 다음주 월요일까지 제출하래	실험 보고서 제출하기	1
텔레비전 켜라	텔레비전 켜기	1
관심 있는 여러분들의 많은 참여 부탁드립니다	참여하기	1
영화 끝나면 연락 주세요	영화 끝나면 연락 주기	1
전염병을 조기 발견 치료하여 시민건강 증진을 도모합시다	전염병 조기 발견 치료하기	1
세계 여자 프로골프 랭킹 관련 기사 찾아주렴	세계 여자 프로골프 랭킹 관련 기사	1
응급 환자가 발생시 일일구로 전화해야 합니다	응급 환자 발생시 일일구로 전화하기	1
옷 따뜻하게 안 입었으면 갈아입고 와라 밖이 상당히 춥다	옷 따뜻하게 입고 오기	1
흡연은 야외 광장을 이용하여 주시기 바랍니다	흡연은 야외 광장에서 하기	1
학습계획은 단원별로 세워봐	학습계획 단원별로 세우기	1
배성호가 보낸 메일 휴지통으로 보내라	배성호가 보낸 메일 휴지통으로 보내기	1
선물 꼭 잊지 말아 안사오면 미워할 거야	선물 사오기	1
책상위를 비춰라	책상위 비추기	1
가족 한 명 삭제해	가족 한 명 삭제하기	1
기다리지마	기다리기	0
너무 빨리 나간다고 생각하시면 뒤에서 경적을 울려주세요	너무 빨리 나간다고 생각하면 뒤에서 경적 울리기	1
김치 냉장고를 보관으로 설정해 주겠니	김치 냉장고 보관으로 설정하기	1
생활 체육 관련 기사를 보자	생활 체육 관련 기사	1
날씨도 더운데 수업 끝나고 팥빙수 먹으로 갈까	수업 끝나고 팥빙수 먹기	1
일부 고점물량 축소하시면서 대응 해	일부 고점물량 축소하며 대응하기	1
정선생에게 온 메일만 표시해	정선생에게 온 메일만 표시하기	1
다음 주 토요일 아침 열 시에 학교 운동장으로 모이세요	다음 주 토요일 아침 열 시에 학교 운동장으로 모이기	1
은수씨 지하철 타고 오세요	지하철 타고 오기	1
입시제도와 관계없이 기본에 충실하세요	기본에 충실하기	1
배우려고 하는 학생은 부끄러워해서는 안 된다	부끄러워하기	0
현관문 자물쇠 좀 보여줄래	현관문 자물쇠	1
버스 맨 뒷자리에 있어 보이면 얼른 타	버스 보이면 타기	1
늦으면 벌금을 물릴 거예요	늦기	0
상인역 앞에서 수요일 저녁 아홉 시쯤 보자	상인역 앞에서 수요일 아홉 시쯤 보기	1
사업해서 돈을 많이 벌었다면 사회를 위해서 써봐	사회를 위해서 돈 써보기	1
교통혼잡이 예상되오니 대중교통을 이용해 주십시오	대중교통 이용하기	1
내방 저장된 화면 좀 보여라	내방 저장된 화면 보이기	1
미 엘피지에이 개막전 관련 기사를 찾아다오	미 엘피지에이 개막전 관련 기사	1
집에 있는 거 다 아니까 빨리 튀어 나와	빨리 튀어나오기	1
산림욕 하러 가지 않을래	산림욕하러 가기	1
야근 한다면서 내가 야식 좀 사가지고 갈게 회사 앞에서 만나	회사 앞에서 만나기	1
공기업 채용 관련 정보를 찾아라	공기업 채용 관련 정보	1
버스정류장을 못 찾겠으면 그냥 택시라도 타고 와라	택시 타고 오기	1
경부 고속도로 진입구간 상황을 알려주렴	경부 고속도로 진입구간 상황	1
전자렌지를 작동시켜 주겠니	전자레인지 작동하기	1
안방 화면을 보자	안방 화면	1
모의 투자는 반드시 겪어야해	모의 투자하기	1
한국의 기차 여행을 예약해	한국의 기차 여행 예약하기	1
테레비 켜줄래	테레비 켜기	1
너무 떨지 말고 연습한대로만 해	연습한대로 하기	2
자수성가한 사업가의 특강이 있으니까 같이 가자	자수성가한 사업가 특강 같이 가기	1
건강 비결에 대한 기사를 찾아라	건강 비결 기사	1
어젯밤에 온 새 이메일 찾아줄래	어젯밤 새 이메일	1
우리 시험 끝나고 찜질방 가자	시험 끝나고 찜질방 가기	1
나 백화점에 옷 환불하러 가야 하는데 같이 가주라	백화점 옷 환불하러 같이 가주기	1
편식은 안 좋아요	편식하기	0
이번 달 쇼핑 이메일 전부 삭제해줄래	이번 달 쇼핑 이메일 전부 삭제하기	1
옷 한벌 사줄게 백화점으로 와	백화점으로 오기	1
아이로비야 고생했다 쉬어라	쉬기	1
좋은 과외 선생님 소개 시켜 줄래 	좋은 과외선생님 소캐시켜주기	1
소비자 보호원에 대한 뉴스를 모두 보여라	소비자 보호원 뉴스	1
동국대 앞 도로가 막히는지 파악해주렴	동국대 앞 도로 막히는지	1
건강 보조식품에 너무 의지하지 마세요	건강 보조식품에 의지하기	0
아직 오십 킬로미터 정도 더 가야 해	오십 킬로미터 정도 더 가기	1
그래도 적금 하나는 들어놔야 편해	적금 하나 들어놓기	1
오랜만에 모임이니 예쁘게 하고 나와	예쁘게 하고 나오기	1
예매를 취소하면 환불되는지 알아볼래	예매 취소 환불 가능 여부	1
이번이 마지막 기회야 꼭 지켜	꼭 지키기	1
재민이 방을 보자	재민이 방 보이기	1
올림픽 국가별 순위 관련 기사를 찾아	올림픽 국가별 순위 관련 기사	1
토요일에 학예회가 개최될 예정이오니 많은 참석 바랍니다	토요일 학예회 참석하기	1
달걀은 한 바구니에 담는 게 아니야	달걀 한 바구니에 담기	0
회사앞 호프집에서 맥주나 한잔 할까 	회사앞 호프집에서 맥주 마시기	1
보일라 꺼	보일라 끄기	1
학교 운동장에서 공이나 차자	학교 운동장에서 공 차기	1
컴퓨터 전원이 꺼져 있는지 확인해주련	컴퓨터 전원 꺼져있는지	1
어린이가 많이 다니는 길에선 주의 하세요	어린이가 많이 다니는 길에선 주의하기	1
어깨가 뭉쳤는데 맛사지 받으러 가자	맛사지 받으러 가기	1
급하니까 오토바이 퀵서비스 불러서 가자	오토바이 퀵서비스 불러서 가기	1
이번 주 토요일 과외를 일요일로 미루자	이번 주 토요일 과외 일요일로 미루기	1
플레이오프 관련 기사 보자	플레이오프 관련 기사	1
웰빙에 맞춰서 아침에 간단한 야채쥬스를 마셔보렴 	아침에 간단한 야채쥬스 마시기	1
경부 고속도로 상에 지체 구간이 있는지 알려주렴	경부 고속도로 상 지체 구간 여부	1
밤에 택시 타는 거 위험하니까 꼭 번호 적어놔	밤에 택시 번호 적어놓기	1
나 다음 주 수요일 날 야외 촬영하는데 같이 가줄래 	다음 주 수요일 야외촬영 같이 가기	1
언니는 네 시쯤 들어가	네시쯤 들어가기	1
현금으로 갖고 다니면 있는 대로 쓰니까 그냥 체크카드로 갖고 다녀	체크카드로 갖고 다니기	1
지난 이 주 간 전국의 날씨를 찾아라	지난 이 주 간 전국 날씨	1
방은 바다가 보이는 방향으로 예약해	바다가 보이는 방향으로 방 예약하기	1
죄송하지만 같은 방향이면 같이 가지요	같이 가기	1
그 약속 지키지는 못했지만 열심히 노력한 것이 헛되지 않도록 마지막까지 최선을 다하자	마지막까지 최선 다하기	1
동부 고속도로 진입로 교통상황은 어떤지 파악해 구간별로 통계정보를 알려다오	동부 고속도로 진입로 교통상황 구간별 통계정보	1
경원대 이메일로 지금 이메일을 보내줄래	경원대 이메일로 지금 이메일 보내기	1
대답 안해	대답하기	1
그래 학교 끝나고 좀 놀자	학교 끝나고 놀기	1
외국인 장기자랑에 대한 포토뉴스를 찾아라	외국인 장기자랑 포토뉴스	1
벼락치기 하지 말고 평소에 공부 좀 해둬	평소에 공부하기	2
슬립 타이머 삼십 분으로 정해	슬립 타이머 삼십 분으로 정하기	1
휴대전화 부당 요금에 대한 기사를 찾아라	휴대전화 부당 요금 기사	1
차선 바꿀 때 항상 주의해	차선 바꿀 때 주의하기	1
반신욕 한번에 오래 하지 마	반신욕 한번에 오래하기	0
취침모드 꺼 줄래	취침모드 끄기	1
정암배 주니어에 관한 기사를 찾아줄래	정암배 주니어에 관한 기사	1
유아 부모님 정기 접종 있습니다 꼭 나오세요	정기 접종 나오기	1
소이 방 가서 컴퓨터 화면 보여	소이 방 컴퓨터 화면	1
성인병을 예방하려면 칼로리 높은 음식 좀 그만 먹어	칼로리 높은 음식 먹기	0
총무에게 연락 하지 않고 빠지신 분은 자진하여 찾아오세요	총무에게 연락하지 않고 빠졌으면 자진하여 찾아오기	1
꾹 참고 살자	꾹 참고 살기	1
교통법규를 위반했을 때 신중한 처신이 필요해	교통법규를 위한했을 때 신중하게 처신하기	1
너 꼭 밥 챙겨 먹고 다녀	밥 챙겨 먹고 다니기	1
건드리지마	건드리기	0
파업을 통해 의지를 관철하도록 합시다	파업을 통해 의지를 관철하기	1
오늘은 나 없을 거야 찾지 마	오늘 나 찾기	0
나와 평생 함께 할 것을 약속해 주실래요 	평생 함께 할 것을 약속하기	1
아테네 올림픽 관련 기사를 보여줄래	아테네 올림픽 관련 기사	1
축구 유소년 캠프 개최 관련 기사 모아줄래	축구 유소년 캠프 개최 관련 기사	1
버스정류장에서 만나서 같이 가자	버스정류장에서 만나서 같이 가기	1
그곳에 가서는 절대 위험한 장소에 가지 않는다고 약속해라	그곳에 가서 위험한 장소에 가기	0
학교면 나랑 같이 공부할래	같이 공부하기	1
대리운전 불러	대리운전 부르기	1
한주의 주식도 소중히 여기자	한주의 주식도 소중히 여기기	1
정수기필터 교환 주기를 알려주라	정수기필터 교환 주기	1
유아의 손이 닿지 않는 곳에 보관하여 주십시오	유아의 손이 닿지 않는 곳에 보관하기	1
공식만 외워도 반이야 외워외워	공식 외우기	1
둥근 보름달 보고 소원을 빌어보세요	둥근 보름달 보고 소원 빌기	1
내일은 자유의 여신상에 가자	내일 자유의 여신상에 가기	1
잡지 읽고 있어	잡지 읽기	1
선풍기 아줌마 관련기사를 보여라	선풍기 아줌마 관련기사	1
기상 특보가 해제된 공항을 알려줄래	기상 특보가 해제된 공항	1
우리 학교 축제야 놀러와	우리 학교 놀러오기	1
급등 종목엔 너무 신경 쓰지 마	급등 종목에 신경 쓰기	0
이번에 같이 바베큐파티 합시다	바베큐파티 하기	1
이번 휴가 때는 같이 스킨스쿠버를 해 보지 않을래 	이번 휴가 때 같이 스킨스쿠버 하기	1
세 사람 북킹해	세사람북킹하기	1
내일 저녁에 쇼핑 같이 하자	내일 저녁 쇼핑 같이 하기	1
초등학교 반창회 모임에 회장이 빠지면 안 되지 꼭 와라	초등학교 반창회 모임에 오기	1
아이들부터 금융 환경의 중요성을 일깨워주자	아이들부터 금융 환경의 중요성 일깨우기	1
내일 회계팀 회식이 있으니 팀원들의 많은 참여 바랍니다	내일 회계팀 회식 참여하기	1
은행마다 이자율이 틀리니까 신중하게 택해야 해	은행 신중하게 택하기	1
이제 곧 황사가 들이닥친다는데 웬만하면 집에서 나오지 마 	집에서 나오기	0
내일 가족 예배 있으니까 일찍 들어와	내일 일찍 들어오기	1
호법 분기점 교통 흐름을 보여주련	호법 분기점 교통 흐름	1
뒷베란다 문을 잠궈주라	뒷베란다 문 잠그기	1
붉은 악마에 대한 기사를 찾아	붉은 악마 대한 기사	1
과음을 하지 마세요 	과음하기	0
이자가 꽤 될텐데 현금 서비스 받지 마	현금 서비스 받기	0
통계자료에 따라 계획하라고	통계자료에 따라 계획하기	1
식기건조기 자외선 살균 시작	식기건조기 자외선 살균하기	1
아홉시로 꺼짐 예약을 해	아홉시로 꺼짐 예약하기	1
세탁기 꺼	세탁기 끄기	1
오늘 유머 보이렴	오늘 유머	1
욕 먹을짓 하지마	욕먹을짓 하기	0
욕실 안 좀 보자	욕실 안 보이기	1
한 달만 사귀어 보기로 해요	한 달만 사귀어 보기	1
간만에 분위기 좋은 식당에 갈까 	분위기 좋은 식당 가기	1
외부 음식물 반입은 금지입니다	외부 음식물 반입하기	0
산악 자전거 동호회 들자	산악 자전거 동호회 들기	1
최근 수신된 메일 날짜별로 보여라	최근 수신된 메일 날짜별로 보이기	1
우리팀보다는 영업팀에 문의하십시요 	영업팀에 문의하기	1
아빠가 외식한다고 일찍 들어오래	일찍 들어오기	1
너 나한테 탁구 배워보지 않을래 	나한테 탁구 배우기	1
핸드폰으로 전화 주시기 바랍니다	핸드폰으로 전화주기	1
유아는 유아용 시트에 태워 뒷좌석에 앉혀야 합니다	유아는 유아용 시트에 태워 뒷좌석에 앉히기	1
카드 잊어 버렸다며 빨리 신고해	카드 신고하기	1
겨울이니까 춥다고 집에만 있지 마라	집에만 있기	0
날씨가 추우니까 잘 챙겨 입어	잘 챙겨 입기	1
그냥 형식적인 인사는 필요 없어	형식적인 인사하기	0
우리 오늘 교외로 드라이브나 가자	오늘 교외로 드라이브 가기	1
바쁜데 좀 빨리 안 될까요	빨리 하기	1
내일 유정이 생일이고 하니까 다들 올 거지	내일 유정이 생일 오기	1
그 시간대는 길이 잘 막히니까 좀 더 뒤에 와	좀 더 뒤에 오기	1
기분 풀어	기분 풀기	1
주식투자는 무리하게 욕심 부리지 않는 게 중요해	주식투자는 무리하게 욕심 부리지 않기	0
이제 곧 황사가 들이닥친다는데 웬만하면 집에서 나오지 마 	집에서 나오지 않기	0
부천 대 삼성의 경기에 관한 기사 모아라	부천 대 삼성 경기 기사	1
주말에 시간 있으면 교외로 나가자	주말에 시간 있으면 교외로 나가기	1
주말에 집에 쳐 박혀 있지 말고 등산이나 가자	주말에 등산 가기	2
식사를 너무 빨리하면 안 좋데	식사 빨리하기	0
말일이니까 서류 마감하고 계획서 제출하세요	서류 마감하고 계획서 제출하기	1
일곱 시까지 못 오시면 안돼요	일곱 시까지 오기	2
웬만한 주가 변동엔 크게 민감할 필요 없어	주가 변동에 민감하기	0
오늘 일찍 들어오세요 여보	오늘 일찍 들어오기	1
고마워요 잔돈은 가지세요	잔돈 가지기	1
다음주에 국제학회가 개최되니 많은 참여 바랍니다	다음주 국제학회 참여하기	1
아무 얘기도 듣고 싶지 않아	얘기하기	0
차에 초보 운전이라고 써 붙이고 나가	차에 초보 운전이라고 써 붙이고 나가기	1
공부장소는 도서관 자유열람실 어때 좋아	도서관 자유열람실 공부하기	1
지금 노을이 너무 예쁜데 너랑 같이 보고 싶다	같이 노을 보기	1
공부 계획을 구체적으로 세워 봐	공부 계획 구체적으로 세우기	1
삼성차 리콜 관련 기사 찾아라	삼성차 리콜 관련 기사	1
내일쯤 여의도에 자전거 타러 갈까 날씨도 좋은데 	내일쯤 여의도에 자전거 타러 가기	1
부엌 뒤 베란다 셔터 내려라	부엌 뒤 베란다 셔터 내리기	1
장수마을의 건강비결 취재하자	장수마을의 건강비결 취재하기	1
택시 타고 들어와	택시 타고 들어오기	1
회신요망	회신하기	1
너의 일을 다 했으면 다른 일도 거들면 좋지	다른 일도 거들기	1
골프장 근처 호텔을 취소해	골프장 근처 호텔 취소하기	1
오늘은 비 오고 쌀쌀하니깐 옷 두껍게 입고 외출하세요	옷 두껍게 입고 외출하기	1
사고 나기 쉬운 밤 운전은 웬만하면 하지 말자	밤 운전 하기	0
분산 예치도 한 번 생각해 봐	분산 예치하기	1
약속 지켰으니까 한턱 쏴	한턱 쏘기	1
스미스 씨한테 저에게서 전화 왔었다고 좀 전해주실래요	스미스씨한테 전화 왔었다고 전해주기	1
세탁기 재가동해 주겠니	세탁기 재가동하기	1
지금 만날 수 없어	지금 만나기	0
약속 절대 어기지마	약속 어기기	0
오늘 밤에 저와 저녁 괜찮으세요	오늘 밤 저녁 먹기	1
시청 로타리 교통 상태는 어떤지 파악해주련	시청 로타리 교통 상태	1
여기 바퀴벌레 너무 많아 해충퇴치회사 상담해볼래	해충퇴치회사 상담하기	1
아무일 없을거야 맘 편히 갖고 기다리자	맘 편히 갖고 기다리기	1
외부 감사를 받는 회사는 주식보유현황을 공시해야 합니다	외부 감사를 받는 회사는 주식보유현황 공시하기	1
다른 주식들이 대거 상승한다고 뒤따라 가면 안되는 거야	다른 주식들 상승 뒤따라 가기	0
네 건강만 챙기지 말고 나도 좀 신경써다오	나도 신경써주기	2
커트만요	커트만 하기	1
냉장고 절전 기능으로 하렴	냉장고 절전 기능으로 하기	1
내 눈병은 옮는 거라고 하니까 내 주위로 접근 금지야	내 주위로 접근하기	0
감기 걸렸다니 오늘 일찍 집에 가서 푹 쉬세요	일찍 집에 가서 쉬기	1
소풍 때 김밥 꼭 싸와 난 유부초밥 준비할게	소풍 때 김밥 사오기	1
내일 우리 유치원 학습발표회야 올 거지 	내일 우리 유치원 학습발표회 오기	1
수상 스키 타러 가자	수상스키타기	1
이번 가을의 기상 전반의 전망을 보여주렴	이번 가을 기상 전반 전망	1
오늘부터 업무시간 중에 인터넷 웹 서핑 삼가 하도록 합니다	업무시간 중에 인터넷 웹 서핑하기	0
티비 한 시간 뒤 취침모드로	티비 한시간 뒤 취침모드로 하기	1
한국의 신용등급 상향조정에 대한 기사를 검색해	한국의 신용등급 상향조정 기사	1
어제 종방된 드라마에 대한 기사를 찾아라	어제 종방된 드라마 대한 기사	1
장애인 올림픽 성적 좀 보여다오	장애인 올림픽 성적	1
조교해야 하는 시간은 비워 두는 게 좋아	조교해야 하는 시간 비워두기	1
목욕물 삼십 팔 도로 맞춰주련	목욕물 삼십팔도로 맞추기	1
수업 끝나고 학교 뒷산으로 나와	수업 끝나고 학교 뒷산으로 나오기	1
내일까지 꼭 한장씩 제출하거라	내일까지 한장씩 제출하기	1
내일 네일아트 받으러 뷰티 샵에 가자	내일 뷰티샵 가기	1
확장자 명을 모조리 바꾸고 상대한테 누출이 안 되게 잘해	확장자 명 모조리 바꾸고 상대한테 누출이 안 되게 하기	1
같이 들을래 	같이 듣기	1
우리 만나서 같이 쇼핑하러 갈까	만나서 같이 쇼핑하러 가기	1
무료영화시사회가 있사오니 많은 관람 부탁드립니다	무료영화시사회 관람하기	1
우리 잘 하자	잘 하기	1
소문에 사고 뉴스에 팔아라	소문에 사고 뉴스에 팔기	1
주식투자는 반드시 여윳돈으로 하는 거다	주식투자 여윳돈으로 하기	1
고향 집에 도착하면 연락줘 기다리고 있을게	고향 집에 도착하면 연락주기	1
반신욕도 체력소모가 많으니 하고 나서 쉬어줘	반신욕 하고 나서 쉬어주기	1
장학금 탔다면서 한 턱 쏴	한턱 쏘기	1
오늘 저녁 말고 점심때 보면 안돼	오늘 점심때 보기	2
양화대교 진입로 상황을 보여주련	양화대교 진입로 상황	1
한 분도 빠지지 말고 참석하세요	참석하기	1
걱정 마	걱정하기	0
검토 후 연락 바랍니다	검토 후 연락하기	1
레알 마드리드 관련 소식을 보여주렴	레알 마드리드 관련 소식	1
에어콘을 십 오 분 후에 꺼주라	에어컨 십오분 후에 끄기	1
첫 월급 받으면 내 선물 사는 것 잊지 않았겠지 	첫 월급 받으면 내 선물 사기	1
찬 바람 분다고 너무 외로워하지 말고 우리 꿋꿋하게 살자 	꿋꿋하게 살기	2
학생증이 발급되었으니까 찾아가세요	학생증 찾아가기	1
성적에 구애 받지 말고 그냥 교양으로 배우는 건 어때 	교양으로 배우기	2
내가 먼저 가서 상황을 볼 테니까 빨리 뒤따라 와	빨리 뒤따라 오기	1
서울 천안 간 정체 구간을 보여주련	서울 천안 간 정체 구간	1
더 이상 튀는 복장은 금지하겠어	더 이상 튀는 복장 입기	0
탄산음료도 되도록 피하는 게 좋아	탄산음료 마시기	0
어제 받은 쇼핑 메일 전부 삭제해	어제 받은 쇼핑 메일 전부 삭제하기	1
상일동 아이씨 좀 보여라	상일동 아이씨	1
안방가서 엄마 뭐하시는지 확인해	안방 엄마 하시는 것	1
결혼식 축가 연습이 수요일 금요일 있습니다 모두 꼭 오세요	결혼식 축가 연습 수요일 금요일 오기	1
모두들 쾌유를 위해 기도합시다	쾌유를 위해 기도하기	1
경보는 다리가 불편해 보여서 웃기던데 그걸 하겠다고 	경보하기	0
다음주 화요일에 시간 비워놔	다음주 화요일 시간 비우기	1
모두 모이라고 연락해	모두 모이라고 연락하기	1
추운날씨에 운동하면 위험하다	추운날씨에 운동하기	0
쇼핑하려고 하니깐 이따 저녁에 꼭 나와서 연락해	이따 저녁에 나와서 연락하기	1
오후 여덟시에 도착하는 것으로 예약해	오후 여덟시에 도착하는 것으로 예약하기	1
경부 고속도로의 현재 교통상황을 알려	경부 고속도로 현재 교통상황	1
올림픽 순위에 대해 나온 기사 보여라	올림픽 순위 기사	1
샤워기 물을 잠가 주겠니	샤워기 물 잠그기	1
횡단보도 건널 때 조심하세요	횡단보도 건널 때 조심하기	1
어느 길이 제일 빠른 길인지 조회 부탁합니다	제일 빠른 길	1
상장 탔다고 들었는데 한 턱 쏴라	한 턱 쏘기	1
여기 보면 영어 뉴스 있으니까 한 번 봐봐	영어 뉴스 한번 보기	1
강아지 밥 좀 줄래	강아지 밥 주기	1
요즘 장사 잘 되간다면서 한 턱 쏴라	한 턱 쏘기	1
김대리한테 전화 업무 좀 부탁해 봐	김대리한테 전화 업무 부탁하기	1
올림픽 심판 오심에 관한 기사를 찾아줄래	올림픽 심판 오심 관한 기사	1
너 통장으로 계좌이체 했으니까 확인해봐	통장 계좌이체 확인하기	1
그 스텝도 연습하면 많이 나아질 거야	스텝 연습하기	1
이십육일 송년회에 참석할 사람 손 드세요 	이십육일 송년회 참석할 거면 손 들기	1
길 안 막히면 좀 일찍 와있어	좀 일찍 와있기	1
길 많이 막히니까 퀵서비스로 보내	퀵서비스로 보내기	1
장기 거래 실태에 대한 기사를 보여라	장기 거래 실태 기사 	1
컴퓨터 게임 시디를 바꿔 주렴	컴퓨터 게임 시디 바꿔 주기	1
조만간 또 연락하자	조만간 연락하기	1
적어도 오백 주 이상을 사야 투자할 가치가 있지 않을까 	오백 주 이상 사기	1
오전 여덟시 명동교차로 상황을 보여주련	오전 여덟시 명동교차로 상황	1
장애인들이 하는 올림픽에 대한 기사 검색	장애인 올림픽 기사	1
설계도서 카피본 관계부서에 보내	설계도서 카피본 관계부서에 보내기	1
너도 동전 모으기 한번 해봐 꽤 짭짭한 수입이야	동전 모으기	1
밥이 보약이야 끼니 거르지 말거라	끼니 거르기	0
해외 진출을 위한 아이디어를 내 주십시오	해외 진출 위한 아이디어	1
남부순환도로에서 올림픽대로로 진입해야 돼요	남부순환도로에서 올림픽대로로 진입하기	1
남아서까지 업무하지 않도록 다들 분발하세요	분발하기	2
나 다음 주 수요일 날 야외 촬영하는데 같이 가줄래 	다음주 수요일 날 야외 촬영 같이 가기	1
회의 중이오니 잠시 뒤에 걸어 주십시오	잠시 뒤에 걸기	1
니스 카니발 여행 예약해	니스 카니발 여행 예약하기	1
날씨가 추우니까 잘 챙겨 입어	잘 챙겨 입기	1
과 사무실에 우편물이 와 있으니 찾아가세요	과 사무실 우편물 찾아가기	1
집에만 있을 거야 햇볕 쬐러 가자	햇볕 쬐러 가기	1
벌써 회의 끝났어 오지 마	회의 오기	0
아침 여섯시 삼십분에 이 번 시디로 켜	아침 여섯시 삼십분에 이 번 시디 켜기	1
좌석을 예약하고 싶어요	좌석 예약하기	1
화장실에 환풍기 꺼주겠니	화장실 환풍기 끄기	1
올 여름 장마의 예상기간을 알려라	올 여름 장마 예상기간	1
경유 항공편 예약해	경유 항공편 예약하기	1
전원을 완전히 꺼라	전원 완전히 끄기	1
우유 왔는지 보고와 줄래	우유 왔는지	1
주말에 나랑 산림욕장 가서 좀 쉬다 올래 	주말에 산림욕장 가서 쉬다 오기	1
식탁 위를 보여주렴	식탁 위	1
카드 잊어 버렸다며 빨리 신고해	카드 분실 신고하기	1
일곱 시에 저 육교 위에서 볼까	일곱 시 육교 위에서 보기	1
잠을 많이 자야 피부가 고와진다 	잠 많이 자기	1
실험실의 안전수칙은 엄수해 주십시요	실험실 안전수칙 엄수하기	1
우리부부 여름휴가 가는 일정을 보이렴	여름휴가 일정	1
경상도 지역의 지역별 날씨 알려줄래	경상도 지역의 지역별 날씨	1
계란은 한 바구니에 담지 말라 모르니	계란 한 바구니에 담기	0
초보일 땐 좌우 잘 살펴야지	좌우 살피기	1
쿠폰 모아 오시면 무료로 제공해 드리고 있사오니 많은 참여 바랍니다	많은 참여하기	1
영화표가 당첨되었는데 같이 보러 갈 수 있어 	영화 같이 보러 가기	1
수요일 점심에 회 먹으러 가자	수요일 점심 회 먹기	1
과 사무실에 우편물이 와 있으니 찾아가세요	과 사무실 우편물 찾아가기	1
복잡하다 구석으로 가 있어라	구석으로 가 있기	1
이천 사 시즌 타자 순위에 대해 알려주련	이천 사 시즌 타자 순위	1
계속 뛰지만 말고 다른 운동을 해봐	다른 운동 해보기	2
나랑 같이 스쿼시 배우러 다니자	같이 스쿼시 배우러 다니기	1
많이 힘들지 내 생각하면서 버텨	내 생각하면서 버티기	1
상관 마	상관하기	0
그냥 소신껏 팔고 소신껏 사버려	소신껏 팔고 소신껏 사버리기	1
샤워 하면서 몸 좀 풀어	샤워하면서 몸풀기	1
지은 씨 편한 데서 만나요	편한 데서 만나기	1
교과서에서만 출제하신다는데 교과서 위주로 공부해	교과서 위주로 공부하기	1
내일 춥데 옷 따뜻하게 입고 나가	내일 옷 따뜻하게 입고 나가기	1
그룹과제는 제출기한에 맞추어 제출해	그룹과제는 제출기한에 맞추어 제출하기	1
내가 전화 하면 바로 뛰쳐나와	전화하면 뛰쳐나오기	1
중국 환율 좀 가르쳐 주지	중국 환율	1
모래 바람 많이 분다 집에 가서 꼭 씻고자	집에 가서 씻고 자기	1
사채는 쓰지 마세요 위험해요	사채 쓰기	0
볕이 좋아 책 읽으러 나가자	책 읽으러 나가기	1
베이스음을 강조해 주겠니	베이스음 강조하기	1
내일 서리가 낄 확률을 보여줄래	내일 서리가 낄 확률	1
내가 필기를 보여 줄 테니까 소주 쏴라	소주 쏘기	1
혼자 끙끙대지 말고 영업팀과 업무를 나눠서 하세요	영업팀과 업무 나누기	2
앞으로 나와의 약속 잊지 말게	나와의 약속 잊기	0
하도급 계약서 가져와 보세요	하도급 계약서 가져오기	1
투자 자산 분산 차원에서 해외 펀드를 가입할 필요가 있어	해외 펀드 가입하기	1
오늘은 그냥 푹 쉬자	오늘은 푹 쉬기	1
까쓰오븐 이백 오십 도로 예열해주라	까쓰오븐 이백 오십도로 예열하기	1
신입 회원들을 맞이하는 자리를 마련하였으니 참석하세요	신입 회원 맞이하는 자리 참석하기	1
휴가철에는 빈집이 많으므로 도둑에 유의 해야 합니다	휴가철 도둑에 유의하기	1
자동이체 안하면 연체되기 쉬워	자동이체하기	1
책은 외국 서적 중심으로 보고 모의 투자를 해 봐	책은 외국 서적 중심으로 보고 모의 투자하기	1
자기개발에 충실한 사원이 됩시다	자기개발에 충실한 사원 되기	1
잠시 후 이륙할 것이니 휴대폰의 전원을 꺼주시기 바랍니다	휴대폰 전원 끄기	1
학습 계획을 세울 때에는 하루하루 할 수 있을 정도만 하세요	학습 계획 하루하루 할 수 있을 정도만 세우기	1
그 동안 잘 지냈냐 내일 첫 휴가 나가니까 얼굴 한 번 보자	내일 얼굴 한 번 보기	1
내일 경기도 용인에서 열리는 워크샵에 다들 늦지 말아요 	내일 경기도 용인 워크샵 늦지 말고 오기	1
옷 사줄꺼지	옷 사주기	1
티비 음소거 해다오	티비 음소거 하기	1
서재 청소기 좀 돌려라	서재 청소기 돌리기	1
각 부서의 의견을 제시해 주시기 바랍니다	의견 제시하기	1
다른 업체에게 뒤지지 않게 힘들내게	다른 업체에게 뒤지지 않기	1
너무 미워하지마	미워하기	0
시험 볼 때 커닝 안 하기로 약속 양심에 맡긴다	시험 볼 때 커닝하기	0
설문지를 작성하신 뒤 퇴장하시면 됩니다	설문지 작성 후 퇴장하기	1
택시 아저씨께 은행 앞에서 세워 달라고 해 	택시 아저씨께 은행 앞에서 세워 달라고 하기	1
토요일 다섯시 까지 깨워라	토요일 다섯시 까지 깨우기	1
아인트호벤 팀 관련 뉴스를 찾아다오	아인트호벤 팀 관련 뉴스	1
방송녹화 시작 해주겠니	방송녹화 시작하기	1
열시 십분에 비디오 녹화 해	열시 십분에 비디오 녹화하기	1
제 책상 위에 있는 서류 좀 팩스로 보내주시겠어요	책상 위 서류 팩스로 보내기	1
천연기념물 발견 기사를 찾아	천연기념물 발견 기사	1
부장님 피곤하실텐데 오전엔 쉬세요	오전에 쉬기	1
현관문 열어주련	현관문 열기	1
한의원에 가서 침 좀 맞아 봐	한의원 가서 침 맞아 보기	1
요즘은 논술이 좌우한대 논술을 중점으로 공부해	논술 중점으로 공부하기	1
좀 떨어진다 싶으면 팔아야 되	좀 떨어진다 싶으면 팔기	1
그런 칼로리가 높은 음식들을 먹지 말고 웰빙음식을 먹어 봐	웰빙음식 먹기	2
이번 결의안의 약속은 꼭 지켜져야 해	이번 결의안의 약속 지키기	1
대중교통 수단을 이용해 그게 훨씬 빨라	대중교통 수단 이용하기	1
너네 학교 뒷산으로 따라와 우리 한판 붙자	한판 붙기	1
태풍 때문에 오늘은 외출을 안 하는게 좋아	오늘 외출하기	0
너랑 만나는 것 너무 지겨워 우리 헤어져	헤어지기	1
우리 시험 끝나고 놀이공원 가자	시험 끝나고 놀이공원 가기	1
삼일절에 교외로 드라이브 가자	삼일절에 교외로 드라이브 가기	1
내일 회의시간 늦지 말고와요	내일 회의시간 늦지말고 오기	1
그래도 한번 치기로 마음 먹었으니 네가 좀 알려주라	알려주기	1
오늘 병원 예약일이야 열한시까지 가면 되	오늘 병원 열한시까지 가기	1
비밀번호 삼 회 오류입니다 은행으로 방문해 주세요	은행 방문하기	1
이거랑은 관계없이 끝내	이거랑 관계없이 끝내기	1
컴퓨터나 인터넷을 적극 활용하세요	컴퓨터나 인터넷 적극 활용하기	1
사스 백신 관련 기사를 보여라	사스 백신 관련 기사	1
부모님방 에어컨 온도 조절해	부모님방 에어컨 온도 조절하기	1
맵고 짠 음식은 너무 좋아 하지마라	맵고 짠 음식 좋아하기	0
오늘 메일에서 뉴스 제목이 있는 메일을 보이렴	오늘 메일에서 뉴스 제목 있는 메일	1
두려워 말고 대출 한 번만 부탁해	대출하기	2
좋은 친구들 많이 사귀고 열심히 해	좋은 친구들 많이 사귀고 열심히 하기	1
축구 유소년 캠프 개최 관련 기사 보자	축구 유소년 캠프 개최 관련 기사	1
이번 거래가 실패한 이유를 내일까지 서류로 제출하십시오	이번 거래 실패 이유를 내일까지 서류로 제출하기	1
오늘 저녁 열시 케이비에스에서 불멸의 이순신 녹화해	오늘 저녁 열시 케이비에스에서 불멸의 이순신 녹화하기	1
자기소개서를 서류에 첨부하는 걸 잊지 마	자기소개서 서류에 첨부하기	1
꽤 쌀쌀한데 그렇게 얇게 입고 다녀도 되겠어 	얇게 입고 다니기	0
내것도 함께 취소해	내것도 함께 취소하기	1
같은 방향이면 같이 타고 가자	같이 타고 가기	1
유비퀴터스에 관련된 소식을 찾아라	유비퀴터스 관련 소식	1
오 번 국도 정체 상황을 보여주렴	오 번 국도 정체 상황 보여주기	1
룸을 하늘이 보이는 방으로 예약해	룸을 하늘이 보이는 방으로 예약하기	1
나올 때 주유권 받아오세요	나올 때 주유권 받아오기	1
아테네 올림픽 금메달리스트에 관한 기사를 보여다오	아테네 올림픽 금메달리스트 기사	1
오늘의 띠별 운세를 찾아라	오늘 띠별 운세	1
건강 검진은 몇 개월에 한 번씩 받으세요	건강 검진 몇 개월에 한 번씩 받기	1
주식 할 때 여유자금으로 하는 거 잊지 마	주식 여유자금으로 하기	1
맛있는 횟집 알아놨는데 같이 가실래요	맛있는 횟집 같이 가기	1
맛있는 거 먹고 싶지 튀김 맛있는데 아는데 같이 갈래 	튀김 맛있는데 같이 가기	1
장학금 탔다며 한턱 쏴	한턱 쏘기	1
동계 올림픽 유치 관련 기사를 찾아	동계 올림픽 유치 관련 기사	1
저녁은 외식하는 게 어때	저녁 외식하기	1
대구 지도 더 크게 보여라	대구 지도 더크게 보이기	1
출발하기 전에 다시 한번 점검 해봐요	다시 한번 점검해보기	1
버스 운전 기사로 취업하고 싶은데 도움 부탁 드립니다	버스 운전 기사 취업 도움 주기	1
내일은 추우니깐 꼭 껴입어	내일 꼭 껴입기	1
경영 도서관에 자리 맡아놨어 한 턱 쏴라	한턱 쏘기	1
신속하게 매매에 임하는 능력이 있어야 해	신속하게 매매에 임하기	1
꾹 참고 살자	꾹 참고 살기	1
내 컴퓨터 바이러스 상황을 체크해	내 컴퓨터 바이러스 상황 체크하기	1
억지로 공부할 필요 없이해야 하는 이유가 분명하면 해	공부하는 이유가 분명하면 공부하기	1
주임님 우리 스쿼시 같이 배워요	스쿼시 같이 배우기	1
쓸데없는 공식을 외우지 마라	쓸데없는 공식 외우기	0
회계 업무 중 모르는 게 있으면 바로 전화해서 물어봐요	회계 업무 중 모르는 게 있으면 바로 전화해서 물어보기	1
아닌 척 하지마	아닌 척 하기	0
남해 고속도로의 교통흐름을 보여주렴	남해 고속도로 교통흐름	1
비가 올 때 래프팅을 하는 것은 매우 위험하니 자제해야 한다	비가 올 때 래프팅하기	0
우리 일광욕 하러 나가자	일광욕 하기	1
꾹 참고 살자	꾹 참고 살기	1
학교 운동장에서 좀 뛰자	학교 운동장에서 뛰기	1
앞으로 유망하다는 종목을 찾아두는 게 좋겠지	앞으로 유망하다는 종목 찾아두기	1
괜찮다 싶으면 면접 약속하면서 만나봐	면접 약속하면서 만나보기	1
내일 저녁 약속 취소했음 좋겠는데	내일저녁 약속 취소하기	1
아 배고파 아웃백 얼른가자	아웃백 얼른 가기	1
오늘의 유가를 보여주렴	오늘의 유가	1
이번 주까지 회비 제출 해 주시기 바랍니다	이번 주까지 회비 제출하기	1
약속을 지켜 신뢰감을 조성하자	약속을 지키기	1
조간 신문 왔는지 화면을 보여라	조간 신문 왔는지	1
인사는 공손하고 예의 바르게 해야 하는 거란다	인사는 공손하고 예의 바르게 하기	1
까쓰렌지 밸브가 잠겼는지 확인해다오	까쓰렌지 밸브 잠겼는지	1
티비 좀 켜 볼래	티비 켜기	1
어제 온 메일 다 지워	어제 온 메일 다 지우기	1
귀국했다는 소식 들었다 당장 연락해라 보고 싶었다	당장 연락하기	1
소이 방에 십 분 뒤에 알람 세 번 울려	소이 방에 십분 뒤 알람 세 번 울리기	1
양산 나들목에 정체가 심한지 알자	양산 나들목 정체 심한지	1
비디오 전원 좀 켜주렴	비디오 전원 켜기	1
유월 삼십일 제 아들 돌이에요 모두 오셔서 축하해 주세요	유월 삼십일 아들 돌 와서 축하하기	1
당뇨병에는 필히 운동이 필요 합니다	운동하기	1
현금으로 들고 있지 마 위험하니까 은행에 넣어놔 	위험하니까 은행에 넣어두기	2
현재 그 은행의 이자 이율을 알고 싶습니다	현재 그 은행 이자 이율	1
경부 고속도로 상황 알려주렴	경부 고속도로 상황	1
오디오 작동 그만해주렴	오디오 작동하기	0
교수님한테 레포트 제출 기한 좀 늦춰달라고 해봐	교수님한테 레포트 제출 기한 늦춰달라고 하기	1
요번 달 이벤트 메일 전부 보여줄래	요번 달 이벤트 메일 전부	1
차가 별로 안 막혀서 일찍 왔어 너도 될 수 있으면 빨리와라	빨리 오기	1
내가 밥을 할테니까 뒷정리는 네가 하기로 해	뒷정리하기	1
어제 강풍 경보 현황을 알려라	어제 강풍 경보 현황	1
홈시어터의 시디 이 번의 영화를 틀어다오	홈시어터 시디 이번의 영화 틀기	1
신용카드 쓰지 말고 체크카드 만들어	체크카드 만들기	2
네가 샀다는 주식 대박 났더라 한 턱 쏴야지	한 턱 쏘기	1
타려고 하는 지하철의 색깔만 따라가면 돼	타려고 하는 지하철의 색깔 따라가기	1
대공원 뒷길에서 걸으면서 이야기하자	대공원 뒷길 걸으면서 이야기하기	1
대출 성공했음 이따가 저녁 쏴	대출 성공했음 이따가 저녁 쏘기	1
내년에 있을 전국체전에 관한 기사를 찾아주련	내년 전국체전 기사	1
택시 할증 붙기 전에 얼른 타고 와	택시 할증 붙기 전에 타고 오기	1
주식투자에서 욕심을 부리지 마라	주식투자에서 욕심부리기	0
녹화 그만	녹화 그만하기	0
오늘 오후에 도착한 메일 모두 보여줄래	오늘 오후에 도착한 메일 모두	1
식 후 삼십분 뒤에 복용하십시오	식후 삼십분 뒤에 복용하기	1
내일 쇼핑할거야 필요한 거 다 적어 놔	필요한 거 적어 놓기	1
올 때까지 기다릴 테니까 꼭 와줬으면 해	꼭 오기	1
일본 야구 관련 뉴스를 뽑아라	일본 야구 관련 뉴스	1
욕 먹을짓 하지마	욕 먹을 짓 하기	0
미국 이모 댁에 공 공 일 공 공으로 걸어	미국 이모 댁에 공 공 일 공 공으로 걸기	1
여우비가 내리니 빨리 우의 입으십시오 	우의 입기	1
우선 버스 타고 의정부로 가있어	버스 타고 의정부 가기	1
이건 내 비상금이야 꼭 갚아	비상금 갚기	1
고객님의 휴면예금 찾아가세요	휴면예금 찾아가기	1
제발 주식 많이 하려고 하지 말고 여윳돈으로 조금만 해봐	주식 여윳돈으로 조금만 하기	1
현관으로 좀 이동	현관으로 이동하기	1
저기 잠깐만요	기다리기	1
논술에 도움이 되는 책 목록을 좀 뽑아 주면 안 돼요	논문에 도움이 되는 책 목록 뽑기	1
잠시만요	기다리기	1
아이들은 생후에 적절하게 예방 접종을 해야 해요	생후에 적절하게 예방 접종하기	1
야간 비행 예약해	야간 비행 예약하기	1
십 인실로 변경할래	십 인실로 변경하기	1
저녁 같이 먹고 싶다	저녁 같이 먹기	1
오븐 속이 깨끗한지 보여줄래	오븐 속이 깨끗한지	1
레알 마드리드팀 새 감독 관련 기사를 찾아	레알 마드리드팀 새 감독 관련 기사	1
술 한잔 사줄꺼지	술 한잔 사주기	1
다 믿지 마	다 믿기	0
휴가 계획안을 올려 주셔야 일정을 조절합니다	휴가 계획안 올리기	1
필리핀 여인과 결혼에 대한 기사를 찾아라	필리핀 여인과 결혼 기사	1
설명회 때 뵙겠습니다	설명회 때 보기	1
저기 구석에 가	저기 구석에 가기	1
제목에 광고라는 말이 들어 있으면 삭제 해줄래	제목에 광고라는 말이 들어 있으면 삭제하기	1
문화원에서 예술 영화 상영회를 한다던데 같이 갈래 	문화원 예술 영화 상영회 같이 가기	1
서해 대교 쪽 정말 막혀 그 쪽으로 가지 말고 국도 타	국도 타기	2
맨날 집에서 뒹굴지 말고 나와	나오기	2
영화 관련 기사를 찾아라	영화 관련 기사	1
일기예보 꼭 확인하고 나가라	일기예보 확인하고 나가기	1
주거래 은행 쪽에 마이너스 대출을 받아봐	주거래 은행 쪽에 마이너스 대출 받아보기	1
야유회에서 재미있게 놀자 	야유회에서 재미있게 놀기	1
앞서서 출발했어 뒤따라와	뒤따라오기	1
공부 계획을 구체적으로 세워 봐	공부 계획 구체적으로 세우기	1
사업 확장은 무리라고 생각하는데	사업 확장하기	0
냉장실 온도 최강 해줄래	냉장실 온도 최강 하기	1
미술관에 기획 전시하는 것 보러 가자	미술관 기획 전시 보러 가기	1
갈비찜 해놓았으니 어서 들어와	어서 들어오기	1
요즘 몸이 안 좋아 보이시는데 보약 한 재 드세요	보약 한 재 먹기	1
다음주 수요일 저녁 여섯 시 동변동 무대포로 오세요	다음주 수요일 저녁 여섯 시 동변동 무대포로 오기	1
양구 경유해서 가	양구 경유해서 가기	1
욕조에 들어있던 것들 좀 빼놓아라	욕조에 들어있던 것들 빼 놓기	1
음악회 티켓 있는데 같이 가자	음악회 같이 가기	1
예비군 훈련이 있으니 전투복 갖춰서 모이시오	전투복 갖춰서 모이기	1
이번 봉급 타면 한 턱 쏘실래요 	이번 봉급 타면 한 턱 쏘기	1
영화 관련 기사를 찾아라	영화 관련 기사	1
오늘 저녁에 있는 동문회 꼭 올 거지	오늘 저녁에 있는 동문회 오기	1
소비 심리 회복세에 대한 기사를 찾아	소비 심리 회복세 기사	1
동남아 관광은 취소해야 할 듯	동남아 관광 취소하기	1
우리나라 월드컵 예선 순위 관련 기사 찾아다오	우리나라 월드컵 예선 순위 관련 기사	1
지난번에 음식은 맛있게 잘 먹었다고 전해드리렴	지난번 음식 맛있게 잘 먹었다고 전해드리기	1
내일 두시부터 공연 있다고 티켓 줬는데 같이 갈래 	내일 두시 공연 같이 가기	1
안방에 불 켜주라	안방 불 켜기	1
팔 인실로 예약 변경해	팔 인실로 예약 변경하기	1
야채나 과일을 많이 섭취하면 좋아	야채나 과일 섭취하기	1
나 조기축구회 들어갈까 하는데 너도 같이 하자	조기축구회 들어가기	1
같이 해볼까	같이 하기	1
아직까지는 많이 덥지 않으니까 선풍기로 버텨	선풍기로 버티기	1
세탁기는 꺼졌는지 보고와라	세탁기 꺼졌는지	1
부장님 피곤하실텐데 오전엔 쉬세요	오전에 쉬기	1
너가 팀장이면 리더쉽을 더 길러야지	리더쉽 더 길르기	1
냉기가 뼈 속까지 스며드는 추위야 몸 관리 잘해	몸 관리 잘 하기	1
부엌으로 이동	부엌으로 이동하기	1
집에서 혼자 침을 놓으시면 위험 합니다	집에서 혼자 침 놓기	0
경주 지도 더 크게 보여주렴	경주 지도 더 크게 보이기	1
어젯밤 도착 이메일 모두 보여라	어젯밤 도착 이메일 모두	1
기분 좋을 때는 감사 하고 나쁠 때는 품위를 지켜라	기분 좋을 때 감사하고 나쁠 때 품위 지키기	1
프로야구 한국시리즈 관련 기사 찾아라	프로야구 한국시리즈 관련 기사	1
단 둘이서 보기로 해 놓고 왜 맨날 그 사람은 데리고 나와	그 사람 데리고 나오기	0
세시까지 컴퓨터 사용을 자제해주십시오 	세시까지 컴퓨터 사용하기	0
특히 집단급식소에서 유의해 주세요	집단급식소에서 유의하기	1
강아지 밥 좀 주고 와라	강아지 밥 좀 주고 오기	1
안방에 불 켜주라	안방에 불 켜기	1
오랜만에 소식 들으니까 굉장히 반갑다 자주 좀 연락해	자주 연락하기	1
주식 할 때 계좌운영을 잘 해야 해	주식할 때 계좌운영 잘 하기	1
보고 싶다	만나기	1
되도록 유기농 녹즙을 먹도록 해	유기농 녹즙 먹기	1
우리 동네에 스쿼시장이 새로 생겼어 언제 한번 같이 가자	동내에 스쿼시장 같이 가기	1
구간별로 통계정보를 알려다오	구간별 통계정보	1
강의실 몇 호야 문자로 보내주라	강의실 호수 문자로 보내주기	1
너무 일에만 묶여있지 말고 여가도 좀 즐겨	여가 즐기기	1
이천 사 경마 경기에 관련된 기사를 찾아주렴	이천 사 경마 경기 관련 기사	1
태풍 오니까 밖에 나가지 마	밖에 나가기	0
초희방 침대 보여주겠니	초희 방 침대 보이기	1
무시 하지마	무시하기	0
골프장 근처 호텔을 취소해	골프장 근처 호텔 취소하기	1
오늘 경기 있다는데 응원하러 가자	오늘 경기 응원하러 가기	1
목욕탕에 같이 가지 않을래	목욕탕 같이 가기	1
내부 순환도로 교통상황을 알려	내부 순환도로 교통상황	1
업무와 일상을 하나로 묶어	업무와 일상 하나로 묶기	1
대문을 잠궈라	대문 잠그기	1
오토바이는 위험하니까 버스를 타고 다니는 게 어때 	버스 타고 다니기	1
미리미리 시험공부를 해둬야지	미리미리 시험공부 해두기	1
자료를 잘 분석해서 하나씩 나눠봐라	자료를 잘 분석해서 하나씩 나누기	1
평망년회 때문에 몸 버리겠다 세 번 이상은 가지 말자	평망년회 세 번 이상 가기	0
그거 예금통장으로 넣으면 되	그거 예금통장으로 넣기	1
부산 시내 교통사고 속보를 알려	부산 시내 교통사고 속보	1
사업안내서 한 부씩 나눠 가져	사업안내서 한 부씩 나눠 갖기	1
환승 버스에선 꼭 카드를 찍고 내려라	환승 버스에선 카드 찍고 내리기	1
수학은 잘 나오니까 사회 쪽으로 비중을 두고 공부해봐	사회쪽으로 비중 두고 공부하기	1
내가 표 끊어 놓을 테니까 터미널로 와	터미널로 오기	1
주식 할 때 계좌운영을 잘 해야 해	주식 계좌운영 잘하기	1
래프팅 하러 가자	래프팅 하러가기	1
카드 결제는 무조건 본인이 해야 맞는 거야	카드 결제 본인이 하기	1
프로젝트 관련 문의는 사무실로 직접 전화 주시기 바랍니다	프로젝트 관련 문의는 사무실로 직접 전화주기	1
간접 펀드에 귀를 기울여봐	간접 펀드에 귀 기울이기	1
장학금 탔다며 한턱 쏴	한턱 쏘기	1
예의 바르게 두 손을 모으고 고개를 숙이며 하는 거야	예의바르게 두 손 모으고 고개 숙이며 하기	1
한산할 때 야외로 나가자	한산할 대 야외로 나가기	1
그 약속 못 지킨 대신 맛있는 밥 한번 쏴라	맛있는 밥 한번 쏘기	1
승준이에게 전화 연결해줄래	승준이에게 전화 연결하기	1
모레 다섯 시쯤에 면접 보러 오래	모레 다섯 시쯤 면접 보러 가기	1
퇴직금 타면 같이 여행가자	같이 여행가기	1
김 대리님이 사업계획서 작성하라셔요	사업계획서 작성하기	1
내 것두 함께 예약해	내 것두 함께 예약하기	1
오늘 꽃샘추위 대단하대 따뜻이 챙겨 입어	따뜻이 챙겨 입기	1
컴퓨터 잘 다루고 싶은데 같이 컴퓨터 학원 다닐까 	같이 컴퓨터 학원 다니기	1
내일 정말 춥대 목도리 매고 가	내일 목도리 매고 가기	1
거긴 우회전 안되니까 뒷길로 와	뒷길로 오기	1
대건 고등학교 앞에서 두 시간 뒤에 보자	대건 고등학교 앞에서 두 시간 뒤에 보기	1
그리스 모린의 방한 일정 관련 기사를 알려	그리스 모린 방한 일정 기사	1
지난달 쇼핑 메일 전부 보여라	지난달 쇼핑 메일	1
내일부터 같이 동네 한 바퀴씩 뛸래 	내일부터 같이 동네 한 바퀴씩 뛰기	1
소독은 너무 자주 실시하면 효과가 반감되니 주의하세요	소독 너무 자주 실시하기	0
잘 다녀오고 갔다 와서 꼭 연락해야 해	갔다 와서 연락하기	1
보고서 낼 때 꼭 양식을 지켜야 합니다	보고서 낼 때 양식 지키기	1
꼭 오세요	꼭 오기	1
오늘 데이트 약속 있는데 이쁘게 입고 가야지	이쁘게 입고 가기	1
한 턱 쏴	한 턱 쏘기	1
취소하시려면 위약금 물어야 됩니다	위약금 물기	0
돈 없다고 너무 싼 종목은 사지 말길	너무 싼 종목 사기	0
허리케인 카트리나에 대한 소식을 보여라	허리케인 카트리나 소식	1
생선회는 먹지마	생선회 먹기	0
선물 꼭 잊지 말아 안사오면 미워할 거야	선물 사오기	1
우리 공부하다가 새벽에 야식 먹자	공부하다가 새벽에 야식 먹기	1
기본 서류 양식 좀 주세요	기본 서류 양식 주기	1
쇼핑할 때 현금 영수증 챙기는 것을 잊지 마	현금 영수증 챙기기	1
안개가 끼면 미등을 켜고 운전해야 합니다	안개가 끼면 미등을 켜고 운전하기	1
골프 회원권 해약 관련 기사를 찾아라	골프 회원권 해약 관련 기사	1
우리 동네에 스쿼시장이 새로 생겼어 언제 한번 같이 가자	우리 동네 스쿼시장 같이 가기	1
인천방향의 국도 상황은 어떤지 파악하고 싶어	인천방향의 국도 상황	1
이리로 와서 찍은 화면 재생 해줄래	찍은 화면 재생해주기	1
현재 풍량 주의보가 해제된 지역 보여주렴	현재 풍량 주의보 해제 지역	1
오늘 먼지 주의경보가 있어서 밖에 나가는 거 삼가 하세요	밖에 나가기	0
우리 시험 끝나고 놀러 가자	시험 끝나고 놀러가기	1
주식 할 때 여유자금으로 하는 거 잊지 마	주식할 때 여유자금으로 하기	1
너무 아파서 내일 만나도록 하죠	내일 만나기	1
아는 오빠가 병에 걸렸어 같이 문병 가 줄래 	같이 문병가기	1
자신 외에는 아무도 믿지 말고	자신 외에 믿기	0
기업 투자 뉴스를 보여라	기업 투자 뉴스	1
조금 기다려야 할 거야	조금 기다리기	1
창문이 닫혔는지 확인 좀 해줄래	창문 닫혔는지	1
오디오를 켜라	오디오 켜기	1
기차표는 예매했어 빨리 하는 게 좋을 걸	기차표 예매하기	1
사람이 몇 명인데 고기 뷔페로 가	고기 뷔페 가기	0
잊지마	잊기	0
친한 친구와 공책을 바꾸어 봐	친한 친구와 공책 바꾸어 보기	1
서울 지방 풍향을 알려주련	서울 지방 풍향	1
총무과에 묻지 말고 관리과에 물어보세요	관리과에 물어보기	2
아침밥 든든히 먹고 나가	아침밥 든든히 먹고 나가기	1
아빠 약속했는데 왜 선물 안 주는 거야 	선물 주기	1
컴퓨터를 준비해서 쉽고도 정확하게 주식시장의 흐름에 대응할 필요가 있어	컴퓨터로 주식시장의 흐름에 대응하기	1
좋은 일자리 있으면 알려줘 바로 갈게	좋은 일자리 있으면 알려주기	1
이 돈 없어도 산다 하는 여윳돈만 투자해	여윳돈만 투자하기	1
저녁 같이 합시다	저녁 같이 하기	1
너무 약 많이 먹는 거 아니냐 약 너무 많이 먹으면 안 좋아 	약 너무 많이 먹기	0
모의투자 대회를 먼저 참여해보는 게 어때	모의투자 대회 먼저 참여하기	1
회계장부 좀 가져와 보세요	회계장부 가져가기	1
인수 인계는 다음 수요일에 말로 하자	인수 인계 다음 수요일에 말로 하기	1
옐로칩들에 주목하세요	옐로칩들 주목하기	1
킹스컵 축구 소식을 알려줄래	킹스컵 축구 소식	1
모노레일 타고 시내 한바퀴 돌자	모노레일 타고 시내 한바퀴 돌기	1
그 쪽 길은 험해서 사고 위험 있어	그 쪽 길 가기	0
이번 달 받은 성인이라는 제목의 이메일 삭제할래	이번 달 받은 성인이라는 제목의 이메일 삭제하기	1
보고 싶어 차에 슈퍼 모터 달고 빨리 와	빨리 오기	1
우리 같이 운동장 열 바퀴 뛰자	같이 운동장 열 바퀴 뛰기	1
다음 주말에 강릉이나 다녀오자	다음 주말 강릉 다녀오기	1
월요일에는 도로가 더 막히니 일찍 나가	월요일에는 일찍 나가기	1
가까운 거리 가더라도 안전벨트 꼭 메	안전벨트 메기	1
장기간 횡보하던 주가가 움직이면 주목해라	장기간 횡보하던 주가가 움직이면 주목하기	1
지면 바로 운동장 열 바퀴다	지기	0
어젯밤 새 메일 중 아이디 토니가 보낸 이메일 찾아라	어젯밤 새 메일 중 토니가 보낸 이메일	1
제조업과 비제조업을 분명히 구분 해둬라	제조업과 비제조업을 분명히 구분하기	1
최경주 선수의 근황 관련 기사 찾아주련	최경주 선수 근황 관련 기사	1
화요일에 회식 있으니깐 약속 잡지 마	화요일 약속 잡지 않기	0
가장 최근 순서대로 이메일 보여라	가장 최근 순서대로 이메일 보이기	1
내일 약속 취소됐으니까 다음에 보자	다음에 보기	1
내일 학생증 지참해야 시험을 볼 수 있데	내일 학생증 지참하기	1
친구 이름도 같이 예약해	친구 이름도 같이 예약하기	1
프로야구 순위와 관련된 기사를 찾으렴	프로야구 순위 관련 기사	1
오늘 영하 오도니까 옷을 단단히 챙겨 입어 	옷 단단히 챙겨 입기	1
약속 어겨봐 죽음이야	약속 어기기	0
반찬을 골고루 잘 먹어야 튼튼해지지	반찬 골고루 잘 먹기	1
내일 모의고사 보는 날 이야 평소대로 해	평소대로 하기	1
냉장실 온도 최강으로 바꿔줄래	냉장실 온도 최강으로 바꾸기	1
레알 마드리드팀 새 감독 관련 기사를 찾으렴	레알 마드리드팀 새 감독 관련 기사	1
내일 출장 가니까 되도록 메일로 보내	되도록 메일로 보내기	1
축구 하러 가자	축구하러 가기	1
남산터널 교통사고 현황을 알려	남산터널 교통사고 현황	1
에스케이 여자 골프에 관한 기사를 찾아줄래	에스케이 여자 골프 기사	1
내일 춥데 옷 따뜻하게 입고 나가	옷 따뜻하게 입고 나가기	1
프로야구 순위와 관련된 기사 찾아	프로야구 순위 관련 기사	1
아이들의 관점도 존중해줄 필요가 있어	아이들의 관점도 존중하기	1
용산구 정체구간 보여볼래	용산구 정체구간	1
주 오일제 근무니까 래프팅 가자	래프팅 가기	1
학교 안 광장에 안개가 쫙 깔렸어 술 마시러 나와	학교 안 광장 술 마시러 나오기	1
화장실은 야외에서 해결 하셔야 할 겁니다	화장실은 야외에서 해결하기	1
야유회에서 재미있게 놀자 	야유회에서 재미있게 놀기	1
문자 안해	문자하기	1
지금 은행이거든 이쪽으로 와	은행으로 오기	1
대출할 때 최고의 싼 금리를 제공하는 금융기관을 찾는 게 중요해	최고의 싼 금리를 제공하는 금융기관 찾기	1
건강한 웃음이 최고 우리 웃고 살자	웃고 살기	1
화장실에 환풍기 꺼주겠니	화장실에 환풍기 꺼주기	1
욕실 불이 꺼졌는지 보여주라	욕실 불이 꺼졌는지	1
엄마 쉬는 날 가족 다같이 여행이나 한번 가요	엄마 쉬는 날 가족 다같이 여행 가기	1
붉은 악마에 대한 기사를 찾아	붉은 악마 기사	1
십이월 오일까지 납부 마감	십이월 오일까지 납부 마감하기	1
차에 너무 많은 옵션을 달 지마	차에 너무 많은 옵션 달기	0
기다려 주십시오	기다리기	1
웹 서비스 이용율 관련 기사 찾아라	웹 서비스 이용율 관련 기사	1
친일파 박정희 관련 소식을 보여라	친일파 박정희 관련 소식	1
학술대회 참가하기로 한 것 잊지 마	학술대회 참가하기	1
소이 방에 가서 십 분 뒤 알람 세 번 울려주련	소이 방에 가서 십 분 뒤 알람 세 번 울리기	1
자신의 생각을 마음껏 표현해 보세요	자신의 생각을 마음껏 표현하기	1
오늘 오후 축구 길거리 응원이 있습니다 참여하세요	오늘 오후 축구 길거리 응원 참여하기	1
건강한 체중을 유지하는 것도 중요해	건강한 체중 유지하기	1
아이로베 거실로 이동할 것	거실로 이동하기	1
보통예금 통장을 하나 만들어서 적금을 드는 건 어때	보통예금 통장 하나 만들어 적금 들기	1
안방문을 열어라	안방문 열기	1
오늘 조선일보에서 운세란을 보여라	조선일보 운세란	1
막내는 며칠에 출장에서 돌아오는지 검색해	막내 출장에서 돌아오는 날짜	1
내일 디즈니랜드 갈건 데 저랑 같이 갈래요	내일 디즈니랜드 가기	1
경기지방 특산물을 찾아라	경기지방 특산물	1
이번 주 수요일에 있는 일정을 모두 지워	이번 주 수요일 일정 모두 지우기	1
소주 한잔 하고 싶어 	소주 한잔 하기	1
여덟시부터 열시까지 거실불 켜 놔	여덟시부터 열시까지 거실불 켜 놓기	1
이번에 유학을 가면 열심히 공부하렴	열심히 공부하기	1
조심해서 운전해야 해	조심해서 운전하기	1
좌석을 예약하고 싶어요	좌석 예약하기	1
오늘 복날이라는데 삼계탕 사 먹어 	삼계탕 사 먹기	1
우장초등학교에서 하차하세요	우장초등학교에서 하차하기	1
요번 여름에도 예쁜 추억 많이 많이 만들자	요번 여름 예쁜 추억 많이 만들기	1
내일 오후 올라가는 열차 예약해	내일 오후 올라가는 기차 예약하기	1
꼬마냄비에 순두부 있으니까 그것도 데워 먹어라	꼬마냄비에 순두부 데워 먹기	1
우리 영원히 헤어지지 말아요 약속	헤어지기	0
롯데팀 순위에 관한 기사 보여다오	롯데팀 순위 기사	1
현금을 전부 수표로 바꿔 둬	현금을 전부 수표로 바꿔 두기	1
가스 밸브 잠궈주라	가스 밸브 잠그기	1
중소형주의 경우에는 규칙저긴 흐름을 보이는 주식에 투자하는 게 좋아	규칙저긴 흐름을 보이는 주식에 투자하기	1
눈길인데 체인 감고 와요	체인 감고 오기	1
회사 측에 한번 건의 해봐	회사 측에 건의하기	1
주말에 교외로 드라이브나 가자	주말에 교외로 드라이브 가기	1
조퇴하기 전에 결재 서류 올려놓고 가	결재 서류 올려놓고 가기	1
강요당하고는 절대로 약속하지 마라	강요당하고 약속하기	0
확고한 주식관을 세우십시오	확고한 주식관 세우기	1
초희방에 가서 컴퓨터 부팅시켜 주겠니	최희방 컴퓨터 부팅시키기	1
올해 여름 장마에 대해서 검색해	올해 여름 장마	1
스키어들의 사고 유형을 잘 파악하고 있어 	스키어 사고 유형 파악하기	1
상일동 아이시의 교통상황을 보자	상일동 아이시 교통상황	1
야전 침대 부탁해	야전 침대 준비하기	1
전국 현재 레이더 영상 보여줄래	전국 현재 레이더 영상 	1
유행성출혈열 예방주사를 맞으세요	유행성출혈열 예방주사 맞기	1
아이들과 재미있는 놀이를 통한 레포츠를 즐기세요	아이들과 재미있는 놀이 통한 레포츠 즐기기	1
할머니 혈압 기록 보여주련	할머니 혈압 기록 보이기	1
절대로 포기하면 안돼 파이팅	포기하기	0
지윤이 한 달 계획표를 보자	지윤이 한 달 계획표	1
버스 타고 가니까 정류장에서 만나	정류장에서 만나기	1
예비군 훈련이 있으니 전투복 갖춰서 모이시오	전투복 갖춰서 모이기	1
정확한 해외증시를 알기 위해서는 해외 증권관련 전문 사이트를 가보는 게 좋아	해외 증권관련 전문 사이트 가기	1
약은 하루에 두 알씩 먹어라	약 하루에 두 알씩 먹기	1
주식은 여윳돈으로 해야지	주식은 여윳돈으로 하기	1
냄비가 넘치면 알려라	냄비가 넘치면 알리기	1
어젯밤에 온 새 메일을 찾아라	어젯밤에 온 새 메일	1
구월 십사일 부터 구월 십팔일의 날씨를 보여	구월 십사일부터 구월 십팔일의 날씨	1
퍼지 세탁해	퍼지 세탁하기	1
다음 주 쯤으로 약속을 미루자	다음주 쯤으로 약속 미루기	1
레포트는 다음주 화요일까지 제출하래	레포트 다음주 화요일까지 제출하기	1
어젯밤 새 메일 중 아이디 토니가 보낸 이메일을 찾아줄래	어젯밤 새 메일 중 아이디 토니가 보낸 이메일	1
강남의 교통상황을 보여주렴	강남 교통상황	1
시력이 안 좋으신 분들은 뒤쪽으로 나와 주시기 바랍니다	시력이 안 좋으면 뒤쪽으로 나오기	1
계획 잘 짜서 좋은 성적 받아	계획 잘 짜서 좋은 성적 받기	1
국보법 폐지에 관한 기사를 검색해	국보법 폐지에 관한 기사	1
내일은 유원지로 야유회를 갑시다	내일 유원지로 야유회 가기	1
서울 리츠칼튼에 일월 일일자로 일 인실 예약해	서울 리츠칼튼 일월 일일자 일 인실 예약하기	1
가까운 거리 가더라도 안전벨트 꼭 메	안전벨트 메기	1
오븐 예열좀 시켜놔	오븐 예열하기	1
기차표 열시쯤 출발하는 표 사	열시쯤 출발하는 표 사기	1
환율 수수료 우대를 받으려면 평소에 이용하던 은행을 가는 게 좋아요	평소에 이용하던 은행 가기	1
모의 투자 대회라도 나가서 실전 경험을 쌓는 것은 어때 	모의 투자 대회 나가 실전 경험 쌓기	1
텔레비전은 하루에 한 시간만 보도록 약속하자	텔레비전 하루에 한 시간만 보기	1
밀린 세금은 이번 주 안으로 납부하세요	밀린 세금 이번 주 안으로 납부하기	1
이번 주까지 야근 부탁드립니다	이번 주까지 야근하기	1
저녁 사줄꺼지	저녁 사주기	1
네가 먼저 가서 영화 예매해놔	먼저 가서 영화 예매해 두기	1
유럽 아시아 정상회의 관련기사 찾아라	유럽 아시아 정상회의 관련기사	1
오늘 곗돈 타서 로또 복권 사러 가자	오늘 곗돈 타서 로또 복권 사기	1
남산공원 근처 출근길 상황 보여다오	남산공원 근처 출근길 상황	1
내일 등산을 갈 계획 중인데 시간 되면 같이 갈까 	내일 등산 같이 가기	1
내리실 문은 우측입니다	우측으로 내리기	1
나중에 얘기해	나중에 얘기하기	1
앞 좌석에 앉아서 운전지도 좀 해줄래 	앞 좌석에 앉아서 운전지도하기	1
고모님께 못 찾아 뵈어서 죄송하다고 전해드려	고모님께 못 찾아 뵈어서 죄송하다고 전해드리기	1
내일 낮 최고 기온이 얼마나 될지 말해줄래	내일 낮 최고 기온	1
여덟시가 되면 알려	여덟시가 되면 알리기	1
아침 저녁으로 꼭 약 먹어	아침 저녁으로 약 먹기	1
손도 녹일겸 카페에 좀 쉬어가자	카페에 좀 쉬어가기	1
비가 많이 와서 신발 관리에 유의하세요	신발 관리에 유의하기	1
주위 환경을 청결하게 유지하는 게 좋아	주위 환경 청결하게 유지하기	1
공연 끝나고 뒷정리 잘해 주세요	공연 끝나고 뒷정리하기	1
유럽 챔피언스리그 관련 기사를 보여라	유럽 챔피언스리그 관련 기사	1
카드 받았으면 뒤에 서명 꼭 해 둬	카드 뒤에 서명 해 두기	1
지친 몸에 꼭 휴식을 취해주시고 꼭 안정을 해야 합니다	휴식 취하고 안정하기	1
이제 돈을 은행에 묶어 두기만 하지마라	돈을 은행에 묶어만 두기	0
오늘까지 내야하는 과제물 꼭 가져와야 한다 	과제물 가져오기	1
오늘 회사 올 때 그 서류 갖고 오는 것 잊지마	회사 올 때 그 서류 갖고 오기	1
힘들어도 쫌만 참으세요 곧 좋아지실 거예요	힘들어도 쫌만 참기	1
구월 십사일 부터 구월 십팔일의 날씨를 보여	구월 십사일부터 구월 십팔일의 날씨	1
아빠 졸음운전 하시면 안 돼요	졸음운전 하기	0
너 바쁘다고 아침밥 거르지 말고 꼭 챙겨먹어라	아침밥 챙겨먹기	2
이대로 거실로 가	이대로 거실로 가기	1
나 너 진짜 좋아 우리 사귈래	사귀기	1
내 생일에 강아지 선물해줘 예쁘게 키울게	내 생일에 강아지 선물하기	1
오늘 기상 특보가 발령된 지역을 알려줄래	오늘 기상 특보 발령 지역	1
지금 오토바이 타고 바로 달려 와	오토바이 타고 바로 달려오기	1
매일메일 거래등급 종목들을 관심종목에 넣어둬	매일메일 거래등급 종목들을 관심종목에 넣어두기	1
오늘 오후에 올라가는 기차 취소해	오늘 오후 올라가는기차 취소하기	1
안방 문을 잠궈주렴	안방 문 잠그기	1
까쓰오븐 이백 오십 도로 십 분 간 세팅해주렴	까쓰오븐 이백 오십도로 십 분 간 세팅하기	1
세계의 움직임 한국의 정서를 파악해야 돼	세계의 움직임 한국의 정서 파악하기	1
요새 인터넷 쇼핑몰 사업이 뜬다던데 나랑 한 번 해볼래	인터넷 쇼핑몰 사업 같이 하기	1
날씨가 춥지만 우리 바다 보러 가자	바다 보러 가기	1
백 도로 예열해 주겠니	백 도로 예열하기	1
어느 길이 제일 빠른 길인지 조회 부탁합니다	제일 빠른 길	1
작은방 온도를 낮춰주렴	작은방 온도 낮추기	1
택배 부칠 때 컴퓨터는 따로 말해서 배송해야 돼	택배 부칠 때 컴퓨터 따로 말해 배송하기	1
박 팀장 우리 회사 옮기자	회사 옮기기	1
이 메일을 전체회신해	이 메일 전체회신하기	1
다리 삐었을 때는 한의원에서 침 맞는 게 제일 좋아요	한의원에서 침 맞기	1
지금 은행이거든 이쪽으로 와	이쪽으로 오기	1
배고파 만나서 밥 먹으면서 얘기하자	만나서 밥 먹으면서 얘기하기	1
비 올지도 모르니까 비 옷 하나 챙겨 오길	비옷하나 챙겨오기	1
계약과 체결은 다른 의미로 보시는 게 맞죠	계약과 체결 다른 의미로 보기	1
내일 저녁 약속 잊지마 늦지 말고 	내일 저녁 약속 잊기 늦기	0
우리 집에서 고기나 구워 먹자	우리 집에서 고기구워먹기	1
공부 잘하고 똑똑하면 뭐해 인간이 돼야지	인간 되기	1
심야에 타는 택시는 조심해야 해	심야 택시 조심하기	1
비가 많이 오는지 확인해	비가 많이 오는지	1
오늘 박찬호 등판과 관련된 기사 모아라	오늘 박찬호 등판 관련 기사	1
해외송금 하고자 하는데 방법 좀 알려주라	해외송금 방법	1
교수님께서 편집 디자인 한 거 빨리 제출 하래	편집디자인 한거 제출하기	1
휴식이 필요 합니다 충분한 휴식을 가지세요	충분한 휴식 가지기	1
신입회원 여러분 열쇠랑 명함 찾아가세요	열쇠랑 명함 찾아가기	1
슬프면 울어 그래야 풀리니까	슬프면 울기	1
현재 풍랑 주의보 해제 지역 보여라	현재 풍랑 주의보 해제 지역	1
기다리지마	기다리기	0
문자 사양이다 나 모든 것이 귀찮다	문자하기	0
두 번째 신호등에서 유턴해	두 번째 신호등에서 유턴하기	1
장외 주식시세에 대해서 알고 싶어	장외 주식시세	1
오늘은 비가 많이 오니까 하루 쉬세요 	오늘 하루 쉬기	1
하루 빨리 눈 수술을 하는 게 좋습니다	빨리 눈 수술하기	1
피곤하면 바깥 바람이나 쐬러 가자	바깥 바람 쐬러 가기	1
내일 첫 월급 타니깐 갖고 싶은가 적어 놔	갖고싶은가 적어놓기	1
넌 피부가 약해서 햇빛 많이 쬐면 안돼	햇빛 많이 쬐기	0
때로는 엉뚱한 친절을 베풀어라	때로는 엉뚱한 친절 베풀기	1
현관문 잠궈주라	현관문 잠그기	1
겨울철엔 고혈압환자가 주의해야한다	고혈압환자가 주의하기	1
안방 텔레비전 사 번 돌려	안방 텔레비전 사 번 돌리기	1
소개팅이라고 너무 예쁘게 입지 말고 따뜻하게 하고 와	따뜻하게 하고 오기	2
날씨가 풀려서 저수지에서 썰매타면 위험하데	저수지에서 썰매타기	0
저축을 게을리 하지 말아라	저축 게을리 하기	0
신용카드 말고 체크카드 써	체크카드 쓰기	2
나만 믿어	나만 믿기	1
보스턴 승리와 관련된 소식 검색	보스턴 승리 관련 소식	1
박주영 기사를 모아볼래	박주영 기사	1
현관에 감시 카메라 작동시켜라	현관 감시 카메라 작동하기	1
주식 할 때는 너만의 투자 철학이 필요해	주식 투자 철학 가지기	1
교통 흐름이 나아졌는지 파악해주련	교통 흐름 나아졌는지	1
그와의 약속을 아무에게도 말하지 말아요	그와의 약속 말하기	0
듣기 싫어	말하기	0
아기 침대 십 분 간 흔들이 모드로	아기 침대 십 분간 흔들이 모드로 하기	1
이번 주 북한산 산악예보 보자	이번 주 북한산 산악예보	1
인터넷 거래 시 사기에 주의하세요	인터넷 거래 시 사기 주의하기	1
백화점 세일기간인데 구경 갈까 	백화점 구경 가기	1
밤이 깊었으므로 청소년 여러분은 속히 귀가해주십시오	속히 귀가하기	1
서양미술의 이해 청강 같이 할래	서양미술의 이해 청강하기	1
엄마에게 물을 가져다 드려라	엄마에게 물 가져다 드리기	1
부장님 호출 이예요 얼른 들어오세요	얼른 들어오기	1
맞선 그래도 안 볼꺼냐	맞선보기	1
먹고 싶으면 연락해 사줄께	먹고 싶으면 연락하기	1
철수야 나 누군지 알지 나 결혼한다 토요일에 축해해주라 	토요일에 결혼 축하해주기	1
햇빛이 너무 강하게 내리쬐니까 그늘로 피하자	그늘로 피하기	1
내일 소풍 가기로 했으니까 너가 김밥 좀 싸와	내일 김밥 싸오기	1
커피 너무 많이 먹지마 해로워	커피 많이 먹기	0
오 번 국도 정체 상황을 보여주렴	오번국도 정체 상황	1
여자 조심해	여자 조심하기	1
조명 조금 어둡게 해주라	조명 조금 어둡게 하기	1
허니 약속 취소하고 일찍 들어오면 안돼	약속 취소하고 일찍 들어오기	1
아니 상황을 화면으로 보여주련	상황을 화면으로 보여주기	1
높은 구두 너무 오래 신지마	높은 구두 오래 신기	0
오늘 새 편지 중 공지 메일을 찾아	오늘 새 편지 중 공지 메일	1
쿠폰 제목이 있는 이메일을 보여라	쿠폰 제목이 있는 이메일	1
오늘 밤에 상도역 사번 출구에서 보자	오늘 밤에 상도역 사번 출구에서 보기	1
같이 잠깐 찬바람 쐬면서 커피 마셔요	같이 찬바람 쐬면서 커피 마시기	1
어제 헤드라인 뉴스를 보자	어제 헤드라인 뉴스	1
오늘 원서 접수 끝납니다 빨리 접수하세요	오늘까지 원서접수하기	1
도로 교통법에 위배되는 행동은 하지 맙시다	도로 교통법에 위배되는 행동 하기	0
오늘 중으로 주민등록등본 좀 띠어주세요	오늘 중으로 주민등록등본 띠어주기	1
문의로 시작하는 이메일을 읽어줄래	문의로 시작하는 이메일	1
날이 너무 더우니까 창문 열고 바람 좀 쐬자	창문 열고 바람 쐬기	1
무더위가 기승을 부릴 때는 되도록 외출을 삼가해	외출 삼가기	0
내일까지 오십만원만 농협통장으로 넣어주라	내일까지 오십만원 농협통장으로 넣어주기	1
너 또 약속 취소하면 정말 화낼 거야	약속 취소하기	0
일본에 있는 유명 온천은 찾아라	일본 유명 온천	1
올림픽 성화봉송에 관한 기사를 찾아줄래	올림픽 성화봉송 기사	1
아침마다 뒷산 올라갔다 와	아침마다 뒷산 올라갔다 오기	1
지영이 누나 지난 번 요점정리 프린트 부탁해요	지난 번 요점정리 프린트 주기	1
식탁 위에 곰국 있으니까 그걸로 아침 먹어라	식탁 위 곰국 먹기	1
방금 전 채널로 바꿔라	방금 전 채널로 바꾸기	1
흥분하지 마세요 혈압 올라가면 위험해요	흥분하기	0
대답 안할거야	대답하기	1
재활용품은 수요일 날 내 주세요	재활용품 수요일 날 내 주기	1
모든 예금을 주식형 펀드로 하는 건 위험해	모든 예금을 주식형 펀드로 하기	0
너 자신과의 약속은 꼭 지키도록 해	자신과의 약속 지키기	1
장소랑 상황을 말하세요	장소랑 상황 말하기	1
너 연체료 빨리 납부하래	연체료 빨리 납부하기	1
차라리 외국 여행 나가려는 사람들한테 직접 파는 건 어때	외국여행 나가려는 사람들한테 직접 팔기	1
수수료는 내가 부담 할 테니 지금 당장 송금해주면 안될까 	지금 당장 송금하기	1
바로 찜질 방 가면 안 된다	바로 찜질방 가기	0
신호가 바뀌어도 차가 멈춘 걸 확인하고 건너	차가 멈춘 걸 확인하고 건너기	1
스터디 계획은 카페에서 확인하세요	스터디 계획은 카페에서 확인하기	1
장학생 되면 한턱 쏴	장학생 되면 한턱 쏘기	1
많은 격려와 응원 부탁드립니다	격려와 응원 하기	1
수표 뒷면에 이서를 좀 해주시겠습니까	수표 뒷면에 이서하기	1
내것두 함께 취소해	내것두 함께 취소하기	1
외환예금통장을 하나 만들어야 해	외환예금통장 하나 만들기	1
책상 위에 네가 말한 서류 올려놨어 가져가	책상 위 서류 가져가기	1
좋은 횟집 알아 놨는데 한번 가야지	횟집 가기	1
이종범 선수에 대한 기사를 보여줄래	이종범 선수 기사	1
북부 순환도로 상황을 보고싶어	북부 순환도로 상황	1
일일 무료 요리 강좌가 예정되어 있으니 참석하세요	일일 무료 요리 강좌 참석하기	1
잘 나갈 때 주위를 살펴야 한다	잘 나갈 때 주위 살피기	1
내가 한 뒤부터 네가 마무리해	내가 한뒤부터 마무리하기	1
시험도 끝났으니 컴퓨터 게임이나 하러 가자	컴퓨터 게임하러 가기	1
공부할 때는 계획이 중요해	공부할 때 계획 세우기	1
지금은 바쁘고 이따가 다시 얘기하자	이따가 다시 얘기하기	1
여행사에 내 사진 보내렴	여행사에 내 사진 보내기	1
혼자 가면 힘들 것 같으니까 박상무가 함께 다녀와	박상무 함께 다녀오기	1
귀찮게 하지 마라 	귀찮게 하기	0
요즘 요가가 유행이라는데 같이 배울까 	요가 같이 배우기	1
나중에 전화 줘 정말 바뻐	나중에 전화 주기	1
빨리 와 기다릴께	빨리 오기	1
커피숍에 들어가 있을테니 도착하면 안으로 와	커피숍 도착하면 안으로 오기	1
주 거래은행과 주 사용카드를 만들어	주 거래은행과 주 사용카드 만들기	1
소이 방에 십 분 뒤 알람 세 번 울려주렴	소이 방에 십 분 뒤 알람 세 번 울리기	1
마지막으로 회포를 풀자	회포 풀기	1
고생했는데 오늘 저녁 회식이나 합시다	오늘 저녁 회식하기	1
너는 정보력이 없고 유행을 모르기 때문에 절대 사업을 해서는 안돼	사업하기	0
누군가 먼저 퇴근하면 뒤따라 나가요	누군가 먼저 퇴근하면 뒤따라 나가기	1
해수욕장 가서 너무 많이 태우지 마	해수욕장 가서 태우기	0
이천 사 시즌 타자 순위에 대해 알려라	이천 사 시즌 타자 순위	1
비과세 저축 통장은 하나쯤은 있어야 합니다	비과제 저축 통장 갖기	1
다음 주 토요일 위생 점검이 있으니 준비해 주시기 바랍니다	다음 주 토요일 위생점검 준비하기	1
공부에 대한 새로운 계획을 세우자	공부 계획 세우기	1
교무실에 가서 과학실 열쇠 받아와	교무실에 가서 과학실 열쇠 받아오기	1
햇빛이 강하니까 모자를 가져 가세요	모자 가져오기	1
김대중씨에 대한 기사를 찾아라	김대중씨 기사	1
삶은 달걀 싸서 기차 소풍 가자	삶은 달걀 싸서 기차 소풍 가기	1
서울 리츠칼튼 호텔 예약을 확인해줄래	서울 리츠칼튼 호텔 예약 확인하기	1
남산공원 가는 길 정체되는지 알 수 있을까	남산공원 가는 길 정체되는지	1
가스렌지 밸브가 잠겼는지 확인해다오	가스렌지 밸브가 잠겼는지	1
콜라 좀 주십시요	콜라 주기	1
영동 고속도로의 현재 상황을 보여주렴	영동 고속도로 현재 상황	1
영동 고속도로의 현재 상황을 보여주렴	영동 고속도로 현재 상황	1
다른 친구에게 연락해	다른 친구에게 연락하기	1
이따가 새벽에 야식 시켜 먹게 한 시까지 와	한 시까지 오기	1
박찬호 관련 기사를 보여다오	박찬호 관련 기사	1
고양이는 밥을 잘 먹는지 확인해	고양이 밥 잘 먹는지	1
아직 해약하지 말고 그냥 둬	해약하기	0
이탈리아전 기사 검색	이탈리아전 기사	1
거실에 불이 켜져 있는지 보고 와	거실 불 켜져 있는지	1
주식담보 융자를 받아 보세요	주식담보 융자 받아보기	1
신용카드 쓰지 말고 체크카드 만들어	체크카드 만들기	2
야전 침대 부탁해	야전 침대 준비하기	1
화요일에 팀 발표 모임하자	화요일에 팀 발표 모임하기	1
현관문 좀 열어 다오	현관문 열어주기	1
장외 주식시세에 대해서 알고 싶어	장외 주식시세	1
그러니깐 요가를 하면서 유연하게 만들어야지	요가를 하면서 유연하게 만들기	1
날도 따듯한데 드라이브 가자	드라이브 가기	1
최근 수신된 메일 날짜별로 보여줄래	최근 수신된 메일 날짜별로 보여주기	1
오늘 불쾌지수를 보여라	오늘 불쾌지수	1
종로구 정체구간을 보여볼래	종로구 정체구간	1
경기지방 특산물을 찾아라	경기지방 특산물	1
샌드위치라도 먹고 있어	샌드위치라도 먹기	1
내일 아홉시까지 좀 꺼져있어	내일 아홉시까지 꺼져있기	1
보일러 온도 이십 오 도로 해	보일러 온도 이십오도로 하기	1
너무 더워서 샤워하고 갈 테니까 조금만 더 기다려	조금 더 기다리기	1
너의 생일날은 꼭 파스타를 먹으러 가자	생일날 파스타 먹으러 가기	1
그냥 외화 전용 통장이나 외국은행에서 만들어	외화 전용 통장이나 외국은행에서 만들기	1
소이 방 십 분 뒤에 알람 세 번 울려라	소이 방 십 분 뒤에 알람 세 번 울리기	1
현금 카드를 교부 받아서 자동화기기를 사용 하라니까	현금 카드 교부 받아 자동화기기 사용하기	1
금연석으로 부탁해요	금연석 주기	1
이번 내기에서 내가 이겼으니까 밥 쏴	밥 쏘기	1
쿠폰 제목이 있는 메일 보여라	쿠폰 제목이 있는 메일	1
오랜만에 모임이니 예쁘게 하고 나와	예쁘게 하고 나오기	1
우유는 왔는지 보고와	우유 왔는지	1
내일 추울 거라니까 옷 많이 겹쳐 입고 나가	내일 옷 많이 겹쳐 입고 나가기	1
테이블에서 계산하세요	테이블에서 계산하기	1
예매기간이 짧으니 잘 기억해놓아야 할 거야	예매기간 잘 기억하기	1
우리가 항상 우정을 지키도록 약속하자	항상 우정을 지키도록 약속하기	1
운동하기 전에 운동장 세 바퀴 뛰어라	운동하기 전에 운동장 세 바퀴 뛰기	1
우리 학교 축제 내일부터야 퇴근하고 놀러 와	내일 퇴근하고 우리학교 놀러오기	1
내일 아버님 퇴원하실 때 형님도 오시는 게 좋겠어요	내일 아버님 퇴원하실 때 오기	1
양치 이외의 용도로는 사용하지 마시길 바랍니다	양치 이외의 용도로 사용하기	0
약속 어기면 붕어빵 사주기	약속 어기면 붕어빵 사주기	1
인수 인계는 다음 수요일에 말로 하자	인수 인계 다음 수요일에 말로 하기	1
최부장님에게 이메일을 쓰자	최부장님에게 이메일 쓰기	1
요즘 우리나라 골프 선수들의 근황을 찾아주렴	우리나라 골프선수들 근황	1
모의투자랑 소액투자로 감을 익혀봐	모의투자랑 소액투자로 감 익히기	1
한강 둔치에 있는 수영장 기온을 보여라	한강 둔치 수영장 기온	1
오늘 꽃샘추위 대단하대 따뜻이 챙겨 입어	오늘 따뜻이 챙겨 입기	1
강아지 좀 깨워라	강아지 개우기	1
최근 이 주일 간 받은 이메일 전부 보여라	최근 이 주일 간 받은 이메일 전부	1
영화 시사회 표가 두장 생겼는데 나랑 같이 보러 가지 않을래 	영화 시사회 같이 보러 가기	1
퇴근길에 슈퍼에 들르자	퇴근길에 슈퍼 들르기	1
샴푸 관련 좌담회가 있습니다 많은 참여 바랍니다	샴푸 관련 좌담회 참여하기	1
단풍놀이 길에는 날씨정보를 꼭 확인해 보는 게 좋을 것 같아	날씨정보 확인하기	1
이차선 도로에서 추월은 절대 금지야	이차선 도로에서 추월하기	0
오늘 꼭 한의원에 가서 침 좀 맞으세요	한의원 가서 침 맞기	1
퇴근 시간 맞춰서 우리 회사 앞으로 와	퇴근 시간 맞춰서 우리 회사 앞으로 오기	1
수상 스키 타러 가자	수상 스키 타러 가기	1
차범근의 최근 현황을 찾으렴	차범근 최근 현황	1
옆에 계신 분은 처음 뵙는데 소개 좀 해주겠어요 	옆에 계신 분 소개하기	1
예의바르게 인사하는 습관을 기르세요	예의바르게 인사하기	1
다음 월드컵 개최국 관련 기사 찾아다오	다음 월드컵 개최국 관련 기사	1
이번 스승의 날에는 선생님 꼭 찾아 뵙자	이번 스승의날 선생님 찾아뵙기	1
수수료도 증권회사마다 차이가 있으니 잘 알아보고 이용해	수수료 잘 알아보고 이용하기	1
오늘 먼지 주의경보가 있어서 밖에 나가는 거 삼가 하세요	오늘 밖에 나가기	0
오토바이는 위험해 타지마	오토바이 타기	0
다음주 수요일 저녁 여섯 시 동변동 무대포로 오세요	다음 주 수요일 저녁 여섯 시 동변동 무대포로 오기	1
브레이크를 너무 쌔게 밝으면 위험하다고	브레이크 너무 쌔게 밝기	0
주가 매도 상태 유지하고 있어	주가 매도 상태 유지하기	1
삼십 분만 잔디 물 좀 주겠니	삼십 분 잔디 물 주기	1
나 열쇠 놓고 왔어 수업 끝나면 바로 집에 와	수업 끝나면 바로 집에 오기	1
지금 빨리 집 앞으로 나와봐	지금 빨리 집 앞으로 나오기	1
교통 사망사고에 관련된 기사를 찾아라	교통 사망사고 관련 기사	1
속리산에 있는 절을 찾아라	속리산에 있는 절	1
오빠 내일 오후에 교외로 드라이브가요	내일 오후 교외로 드라이브 가기	1
초복이다 잊지 않고 삼계탕이라도 먹고 더위 이겨	삼계탕 먹기	2
세탁기를 핸드폰으로 연결해줄래	세탁기를 핸드폰으로 연결하기	1
졸지마	졸기	0
손해 안 보려면 그냥 너 넣고 오래 둬	너 넣고 오래 두기	1
날도 따듯한데 드라이브 가자	드라이브 가기	1
오늘 아침에는 출근길 많이 막히나 알려라	오늘 아침 출근길 많이 막히는지	1
삼십 분만 잔디 물 좀 주겠니	삼십 분 잔디 물 주기	1
장소 바꾸지마 금방 갈께	장소 바꾸기	0
최근 윔블든 테니스 대회에 대한 기사를 보여주렴	최근 윔블든 테니스 대회 기사	1
십 오 분 뒤에 안방 불 꺼줄래	십오분 뒤 안방 불 끄기	1
잠시만 기다려	잠시 기다리기	1
내일 모레의 자외선 지수를 말해	내일 모레 자외선 지수	1
대문 잠금기능 설정해	대문 잠금기능 설정하기	1
점심에는 간단하게 샌드위치를 먹자	점심 샌드위치 먹기	1
용산에 위치한 태국요리 전문점 알려줄래	용산 위치 태국요리 전문점	1
전화 안하지	전화하기	1
수락산 터널 진입로 교통상황을 보이렴	수락산 터널 진입로 교통상황	1
저 구석으로 가 있어	구석으로 가 있기	1
저녁 회식은 일식 집에서 하죠	저녁 회식 일식 집에서 하기	1
현관문 잠겼는지 좀 보여라	현관문 잠겼는지	1
오토바이 탈 때엔 옷을 되도록 두껍게 입으세요	옷 되도록 두껍게 입기	1
서울로 무궁화호 두 장 예약해	서울로 무궁화호 두 장 예약하기	1
시험 날 아침에는 여유 있게 준비하는 게 좋아	시험날 아침에 여유있게 준비하기	1
슈퍼마켓에서 무거운 짐을 나르는 것이 너의 일이야	슈퍼마켓에서 무거운 짐 나르기	1
분기별 주가 등락률을 합산해	분기별 주가 등락률 합산하기	1
깜빡하고 우산을 놔두고 왔는데 지금 좀 가지고 와 줄 수 있어 	우산 지금 좀 가지고 와 주기	1
오늘 오후에 여행사에 다시 물어볼래	오늘 오후 여행사에 다시 물어보기	1
이번 여행으로 보다 많은 것을 배워가길 바래	여행으로 많은 것을 배워가기	1
주식의 종류에는 무엇이 있는지 알아봐 	주식의 종류	1
전기 오븐에 불이 켜져있나 확인해줄래	전기 오븐에 불이 켜져있나	1
이제 그만 만나	만나기	0
수능의 출제 형태를 알아놓아라	수능의 출제 형태	1
비도 오는데 집에서 비디오나 빌려보면서 뒹굴뒹굴할까	집에서 비디오 빌려보며 뒹굴뒹굴하기	1
잘 모를 경우에는 증권회사 직원에게 추천을 받으세요	증권회사 직원에게 추천받기	1
지금이라도 수입의 이십 퍼센트를 개인연금에 투자하자 	수입 이십 퍼센트 개인연금에 투자하기	1
해외여행 갔다와서 동전은 교환이 안되니까 미리 바꿔서 와	동전 미리 바꿔서 오기	1
잠실대교 북단 교통 흐름을 알려주련	잠실대교 북단 교통 흐름	1
내일 가족 예배 있으니까 일찍 들어와	내일 일찍 들어오기	1
대신 나의 안부를 그 사람에게 전해주세요	나의 안부를 그사람에게 전하기	1
오토바이 탈 때엔 옷을 되도록 두껍게 입으세요	옷 두껍게 입기	1
채무자에게 효과적인 변제 방안을 제시해 줄 것을 요구한다	채무자에게 효과적인 변제 방안 제시해 주기	1
세부사항은 홈페이지의 공지사항을 참고하시기 바랍니다	세부사항은 홈페이지의 공지사항 참고하기	1
케이 리그 기사를 모아볼래	케이 리그 기사	1
너 사채는 절대로 쓰면 안돼	사채 쓰기	0
행사요원들은 방송 듣는 즉시 본부로 모여 주시기 바랍니다	행사요원은 방송 듣는 즉시 본부로 모이기	1
긴급 회의가 있습니다 회의실로 모여주세요	회의실로 모이기	1
친구야 나 노트 좀 빌려주라	노트 빌려주기	1
창문밖에 나가있어 줄래	창문밖에 나가있기	1
내가 이래 봐도 태권도 일단이야 까불지 마	까불기	0
오늘 우체국에 가서 서류 좀 빠른 우편으로 부치세요	오늘 우체국에 가서 서류 빠른 우편으로 부치기	1
내일부터 우리 죽음의 다이어트 시작하는 거야	내일부터 다이어트 시작하기	1
예약한 것 아홉시로 변경해	예약한 것 아홉시로 변경하기	1
내일 마산의 불쾌지수를 보여줄래	내일 마산 불쾌지수	1
단기 과열만 보고 투자하지 마 묻지 마 투자는 금물이야	단기 과열만 보고 묻지 마 투자하기	0
너 자꾸 신용카드 쓰는 버릇하면 안 좋아	신용카드 쓰는 버릇하기	0
하우젠컵 대회 관련 기사 찾아다오	하우젠컵 대회 관련 기사	1
조금만 기다려봐 	조금 기다리기	1
카르로스 해트트릭 관련 기사 검색	카르로스 해트트릭 관련 기사	1
결혼식 못 가니까 대신 축의금 부쳐 준다고 해 봐	축의금 부쳐 준다고 하기	1
물속에 너무 오래 있지 말고	물속에 오래 있기	0
한국일보 사설만 보여라	한국일보 사설만 보이기	1
이번 주 토요일 오후 두 시에 미팅이니까 시간 비워둬	이번 주 토요일 오후 두 시 미팅하기	1
영희야 배당보고 투자하면 절대로 안 돼	배당보고 투자하기	0
맞기 싫으면 내 말대로 해	내 말대로 하기	1
학생들의 두발을 앞머리 십 센티 귀밑 삼 센티로 바꿉니다	두발 앞머리 십 센티 귀밑 삼 센티로 바꾸기	1
동부 간선도로를 지나는데 소요되는 시간은 얼마나 되는지 알려라	동부 간선도로 지나는데 소요되는 시간	1
골프장 근처에 호텔예약해	골프장 근처 호텔 예약하기	1
어제 뉴욕 올리언즈팀 관련 기사 찾으렴	어제 뉴욕 올리언즈팀 관련 기사	1
당뇨병 환자는 이약의 복용을 금합니다	이 약 복용하기	0
김성식한테 온 이메일 확인해줄래	김성식한테 온 이메일	1
회의 후 연락주세요	회의 후 연락주기	1
지금 당장 보자	지금 당장 보기	1
어젯밤에 온 새 이메일을 찾아보렴	어젯밤에 온 새 이메일	1
남해 고속도로 정체구간을 알려주렴	남해 고속도로 정체구간	1
티비 꺼졌는지 보고 올래	티비 꺼졌는지	1
몸도 유연해질 겸 댄스스포츠 같이 다니자	댄스스포츠 같이 다니기	1
카드발급 요즘 힘들다던데 그냥 카드 없이 살지 그래	카드 없이 살기	1
오월엔 꼭 같이 나들이 가자	오월에 같이 나들이 가기	1
다음 체육대회 때 배드민턴 대회 나가자	다음 체육대회 때 배드민턴 대회 나가기	1
내일 비가 오는 경우 정규 수업 준비해 오세요	정규 수업 준비하기	1
샤라포바의 방한 관련 기사 찾아	샤라포바 방한 관련 기사	1
직접 사과한다고 약속했어 너도 그만 화 풀어	화 풀기	1
새천년 교통문화 양보로 가꿉시다	교통문화 양보로 가꾸기	1
집에 비디오카메라 챙겨와	집에 비디오카메라 챙겨오기	1
십분 후면 도착하니까 미리 주문해 놔요	미리 주문해 두기	1
여름에는 바닷가에서 해수욕이나 하자	여름에 바닷가에서 해수욕 하기	1
공부도 좋지만 여유를 좀 가지고 살아라	여유 가지고 살기	1
아까 보내드린 서류 결재 부탁 드립니다	아까 보낸 서류 결재하기	1
감기에는 땀 빼는 게 최고야 푹 자요	땀 빼고 푹 자기	1
복도에서 만나면 가볍게 목례로 인사를 해주시기 바랍니다	복도에서 만나면 가볍게 목례로 인사하기	1
아버지께서 병원에 입원하셨으니 빨리 오너라	빨리 오기	1
보안 관계상 사진 촬영은 불가합니다	사진 촬영하기	0
월요일 일정을 모두 취소해	월요일 일정 모두 취소하기	1
여름휴가로 해외여행을 가자	여름휴가로 해외여행 가기	1
나랑 같이 스쿼시 배우러 다니자	같이 스쿼시 배우러 다니기	1
아기 방에 가 있어	아기 방에 가있기	1
막히는 곳이 여전히 많은지 알려주련	막히는 곳이 여전히 많은지	1
회의 끝나는 대로 연락주세요	회의 끝나는 대로 연락주기	1
스포츠 댄스 같이 다니자 응 	스포츠댄스 같이 다니기	1
호법 분기점의 교통 흐름 보여주련	호법 분기점 교통 흐름	1
십이월 오일까지 납부 마감	십이월 오일까지 납부 마감하기	1
내 것두 함께 예약해	내 것두 함께 예약하기	1
작은방에 텔레비전이 켜져 있는지 확인해다오	작은방에 텔레비전 켜져 있는지	1
외국돈 바꿀 때 외환은행에서 하길	외국 돈 외환은행에서 바꾸기	1
신호위반을 하셔서 벌금을 내셔야 합니다	벌금 내기	1
바다에 해수욕 하러 가자 튜브 들고 와	바다에 해수욕하러 가기 튜브 들고 오기	1
할인되는 날이 있는지 확인해	할인되는 날 여부	1
지금 도서관인데 빨리 와	빨리 오기	1
열심히 해	열심히 하기	1
김현철에 대한 기사를 모두 찾아라	김현철에 대한 기사 모두	1
버스운행 시간은 이십분마다 있으니까 안심해	안심하기	1
해외 오퍼레이터 부탁해요	해외 오퍼레이터 준비하기	1
열차표 예약해	열차표 예약하기	1
너 지금 어디있는지 위치를 알려라	지금 위치	1
현재 전국 풍량 주의보가 발표된 지역을 보여	현재 전국 풍량 주의보 발표 지역	1
반송되어 온 메일을 알려줄래	반송되어 온 메일	1
아이로비 야 이리로 좀 와	이리로 오기	1
장외 종목은 제외 시키세요	장외종목 제외하기	1
내일 회식에는 한 명도 빠짐없이 참석해	내일 회식 참석하기	1
수화물 표를 보여주실래요	수화물 표 보여주기	1
국내야구 화보 보여주렴	국내야구 화보	1
현금카드도 신청하세요	현금카드 신청하기	1
은행에 올 때 도장도 챙겨와	도장 챙겨오기	1
날 더운데 살들 안 빠지게 잘 관리하셔	살 안 빠지게 관리하기	1
오늘 걔들 백일이래 파티 한다니까 모이자	모이기	1
공부 잘하기 전에 사람이 먼저 되라	사람이 되기	1
주식 그거 마약과도 같은 거라서 너무 빠지면 위험할텐데 	주식에 빠지기	0
인터넷 쇼핑한거 입금해야 돼	인터넷 쇼핑 입금하기	1
요새 휘발유 값이 얼만데 아껴야지	휘발유 아끼기	1
오늘 박찬호 등판과 관련된 기사 보여주렴	오늘 박찬호 등판 관련 기사	1
티비 음소거 시켜줄래	티비 음소거 시키기	1
철수한테 전화해주련	철수한테 전화하기	1
월요일에는 도로가 더 막히니 일찍 나가	월요일에는 일찍 나가기	1
여기 음주단속해서 위험해 다른 길로가	다른 길로 가기	1
까쓰중독 기사를 모두 보여라	까쓰중독 기사	1
농협 수수료 안 물게 만원씩만 출금해	만원씩만 출금하기	1
너 자꾸 빨간 불일 때 건너지 마	빨간 불일 때 건너기	0
종교에 관련된 신문을 찾아라	종교 관련 신문	1
은행가서 동전좀 바꿔다 줄래요	은행가서 동전 바꿔다 주기	1
세탁기를 돌려주겠니	세탁기 돌리기	1
첫째 이메일 열어	첫째 이메일 열기	1
지하철 탈 때는 졸지 않도록 주의해야 해	지하철 탈 때 졸기	0
에어컨을 이십 삼 도로 온도 조절해주겠니	에어컨을 이십 삼 도로 온도 조절하기	1
규칙적인 수면은 공부에 도움이 돼	규칙적인 수면하기	1
검은색 볼펜만 사용해야 하며 그 외 도구는 실격입니다	검은색 볼펜만 사용하기	2
붉은악마 관련 소식을 보여줄래	붉은악마 관련 소식	1
이런 상황에서 그 주식을 사는 것은 자살 행위야	그 주식 사기	0
엄마 저 월세를 못 내고 있어요 빨리 입금 좀 해주세요	입금하기	1
효도화가 건강 신발이라던데 부모님께 선물해봐	건강 신발 부모님께 선물하기	1
회의 때 필요한 이 서류들 삼십매씩 복사 부탁드려요	이 서류들 삼십매씩 복사하기	1
이번달 이자 입금이 안됐으니까 확인 좀 해봐	이번달 이자 입금 확인하기	1
다음 주에 콘서트 표 예매해놨어 같이 보러 가자	다음 주 콘서트 같이 보러 가기	1
꼭 좌석표 지참해야 해	좌석표 지참하기	1
삼겹살 사다 구워 먹자 훨씬 싸	삼겹살 사다 구워 먹기	1
시내 마을 버스 노선 관련 기사를 찾아라	시내 마을버스 노선 관련 기사	1
기아팀 농구 경기 관련 기사 찾아다오	기아팀 농구 경기 관련 기사	1
내일부터 백화점 세일인데 같이 쇼핑 갈래 	내일 같이 쇼핑 가기	1
울지마 임마 내가 있는데 왜 우는 거야	울기	0
컴퓨터로 할 수 있는 사업들에 대해 알고 싶어	컴퓨터로 할 수 있는 사업들	1
이리로 와라	이리로 오기	1
우리 같이 계 하나 해볼래 	같이 계 하나 하기	1
과음을 하지 마세요 간이 더 안 좋아 집니다	과음하기	0
오 분 뒤 버스가 출발하니 서둘러 탑승하시길 바랍니다	버스 서둘러 탑승하기	1
언제 시간 나면 선생님 한 번 찾아 뵙고 인사 드리도록 해	선생님 찾아뵙고 인사 드리기	1
주식 투자는 여윳돈이 없으면 절대 하지 마	여윳돈 없이 주식 투자하기	0
시험을 치기 위해 신분증을 지참해 주세요	신분증 지참하기	1
모두 모이라고 연락해	모두 모이라고 연락하기	1
금요일 날 볼링모임에 나올 거지 	금요일 날 볼링모임에 나오기	1
좀만 더 기다려봐 언젠간 오를 거야	기다리기	1
예의를 갖추는 자리에선 절을 해야 하는 거야	절 하기	1
오빠가 병원도 좀 데려 가드리고 그래	병원 데려 가드리기	1
이 번에 첫 월급 탔다며 한 턱 쏴라	한턱 쏘기	1
고속철 일반석으로 예약해	고속철 일반석 예약하기	1
상속세 관련 기사를 보여라	상속세 관련 기사	1
업무 처리 다 하시고 가시는 거예요	업무 처리 다 하고 가기	1
한강교량 구간의 통행 소요 시간은 얼마나 되는지 파악해주련	한강교량 구간 통행 소요시간	1
포인트 제목 있는 이메일을 보여줄래	포인트 제목 있는 이메일	1
돌아오는 주말까지 모두 완료하여 보내주시기 바랍니다	돌아오는 주말까지 모두 완료하여 보내기	1
작업실 열쇠 갖고 간사람 연락 부탁드립니다	작업실 열쇠 갖고 갔으면 연락하기	1
올 여름 장마의 예상기간 알려줄래	올 여름 장마 예상기간	1
자신 외에는 아무도 믿지 말고	자신 외에는 아무도 믿지 않기	1
귀찮더라도 밥은 꼭 해서 먹어	밥 먹기	1
날씨도 안 좋은데 그냥 우리 커피숍 가자	커피숍 가기	1
특별히 신경 좀 써	특별히 신경쓰기	1
택시 할증 붙기 전에 얼른 타고 와	얼른 택시 타고 오기	1
나 너무 외로운 거 있지 흑 너무 보고 싶어	만나기	1
오늘까지 리포트 꼭 제출하세요	오늘까지 리포트 제출하기	1
공부하기 전에 먼저 계획을 세워	공부하기 전 계획 세우기	1
황사에 대한 정보를 보자	황사 정보	1
강변북로 서측구간의 전반적인 흐름은 어떤지 보여라	강변북로 서측구간 전반적 흐름	1
흐름이 너무 불규칙한 소형주도 관심을 두지 않는 게 좋아	소형주 관심두기	0
입시 정책 관련 기사를 찾아라	입시 정책 관련 기사	1
쿠폰 제목이 있는 메일 보여줄래	쿠폰 제목이 있는 메일	1
스파게티 공짜 쿠폰 있는데 먹으러 가자	스파게티 먹으러 가기	1
더블 침대 사전 예약해	더블 침대 사전 예약하기	1
엄마가 너 빨리 들어오래	빨리 들어오기	1
오늘은 그냥 푹 쉬자	오늘은 푹 쉬기	1
가장 효과적인 공부계획에 대한 조언을 듣고싶습니다	가장 효과적인 공부계획	1
작은방 모니터 꺼주렴	작은방 모니터 끄기	1
다른 주식들이 대거 상승한다고 뒤따라 가면 안되는 거야	다른 주식  상승 뒤따라 가기	0
이번 주 방송일정을 모두 말해	이번 주 방송일정	1
나만 믿어	나만 믿기	1
돌아오는 추석에는 아버지 찾아 뵈러 갈 건데 같이 갈래 	돌아오는 추석에 아버지 찾아 뵈러 같이 가기	1
지금 남산터널 상황을 보여주렴	지금 남산터널 상황	1
십일월 오일 할아버님 제삿날로 기록해	십일월 오일 할아버님 제삿날로 기록하기	1
모르는 거 있으면 체크해 뒀다가 다음 주에 물어봐	모르는 거 있으면 체크해 뒀다가 다음 주에 물어보기	1
염색약이 독하대 염색은 되도록 안 하는 게 좋아	염색하기	0
빨리 오십시요	빨리 오기	1
나 소개팅 시켜준다며 왜 연락이 없어 	소개팅 시켜주기	1
그 동네 위험하니까 일찍 다녀	일찍 다니기	1
동요대회에서 반주자는 필히 동반해야 됩니다	동요대회에서 반주자 동반하기	1
우리 아빠는 예의에 어긋난 사람을 싫어하니까 미리 알아둬	예의에 어긋난 행동 하기	0
약 드세요	약 먹기	1
손 들어	손 들기	1
관절이 안 좋으면 정형외과를 가야지	정형외과 가기	1
오늘까지 구구단 다 외우세요	오늘까지 구구단 다 외우기	1
우리 집에서 과외선생님이 오실 것 같으니까 너도 지금 와	우리 집에 지금 오기	1
오늘 못 만나면 안돼 꼭 나와	오늘 꼭 나오기	2
그렇게 뛰고 싶으면 집 앞을 달려라	집 앞 달리기	1
컴퓨터를 부팅시켜주련	컴퓨터 부팅시키기	1
경비 시스템 작동 시작해 주겠니	경비 시스템 작동 시작하기	1
그럼 그때 그 자리에서 보자고	그때 그 자리에서 보기	1
지하철 이 호선은 너무 더워 타지마	지하철 이 호선 타기	0
케이 원이라는 것에 대한 기사 검색	케이원 기사	1
우리 시험 끝나고 놀러 가자	시험 끝나고 놀러 가기	1
샤워기 수압을 절반으로 낮춰주라	샤워기 수압을 절반으로 낮추기	1
난 정말 만나기 싫어	만나기	0
패밀리마트 앞으로 지금 나와	패밀리마트 앞으로 나오기	1
문 좀 열어 줄래	문 열어주기	1
오후 아홉시 도착하는 것으로 예약해	오후 아홉시 도착하는 것으로 예야하기	1
옷은 알아서 잘 챙겨 입고 다녀	옷 챙겨 입고 다니기	1
회의와 관련된 주제만 다뤄	회의 관련 주제만 다루기	1
육자회담 결렬에 대한 소식을 찾아라	육자회담 결렬 소식	1
집 앞에 누가 있는지 좀 보여	집 앞 사람	1
쭉 오다가 성산대교에서 진입하면 돼	쭉 오다가 성산대교에서 진입하기	1
오늘이 축제 하이라이트야 꼭 보자	오늘 축제 하이라이트 보기	1
급격한 생활의 변화는 건강에 위험하니까 조심해	급격한 생활의 변화 갖기	0
신불자 구제에 대해 찾아라	신불자 구제	1
오늘 한번 찐하게 놀까	오늘 찐하게 놀기	1
국제협의회에 참여하여 의견을 제시해 주시기 바랍니다	국제협의회에 참여하여 의견 제시하기	1
그 병원에 입원했어 같이 가자	그 병원에 같이 가기	1
다음 주 수요일에 행사에 와서 도와줄래 	다음 주 수요일 행사 도와주기	1
분산 예치도 한 번 생각해 봐	분산 예치하기	1
우리나라의 국경일 날짜를 모두다 검색하렴	우리나라 국경일 날짜 모두	1
배구 슈퍼리그에 관한 소식을 찾아줄래	배구 슈퍼리그 소식	1
고속도로라도 너무 빨리 달리지 말아요	빨리 달리기	0
우리 스터디 짜서 같이 공부할까 	스터디 짜서 같이 공부하기	1
추운 날에는 손 난로 하나쯤 준비해야지	손난로 준비하기	1
연휴 마지막 날의 맑은 날씨를 즐기세요	맑은 날씨 즐기기	1
전기 밥솥 보온으로 해놔	전기 밥솥 보온으로 해놓기	1
불쾌지수 표를 보여라	불쾌지수 표	1