요요 현상을 극복하려면 어떻게 해야 할까 	요요 현상 극복 방법	2
마포 소재 출판사는 어떻게 가	마포 소재 출판사 가는 방법	2
수업 두 시간만 하고 끝난데	수업 두 시간만 하는지	0
이번 주말에 과외 몇 시냐	이번 주말 과외 시각	2
건강하시죠	건강한지	0
점심은 뭐 먹었니 난 복날이라고 삼계탕 챙겨 먹었다	점심 먹은 것	2
전에는 어떤 곳에 가 보셨나요	전에 가 본 곳	2
과외가 나을까 학원이 나을까	과외 학원 중 나은 것	1
괜찮으세요	괜찮은지	0
왜 바닷가에는 눈이 잘아오는 걸까 	바닷가 눈 잘아오는 이유	2
점심은	점심 먹었는지	2
민망해	민망한지	0
이번에 심리학이 철회 됐대	심리학 철회 여부	0
방배동 파출소는 어디니	방배동 파출소 위치	2
창업 컨설턴트를 전문으로 해 주는 곳 믿을 만 한 거야	창업 컨설턴트 전문 믿을 만 한지	0
장내 주식을 장외에서 매입 가능한가요	장내 주식 장외 매입 가능 여부	0
이번 달 무선인터넷 사용료 내는 날은 언제야	이번 달 무선인터넷 사용료 내는 날	2
추위도 이번 주가 마지막이래	추위 이번 주 마지막인지	0
화랑로 월곡 방향은 흐름이 원활해	화랑로 월곡 방향 흐름 원활 여부	0
너 지분율 몇 퍼센트냐	지분율 퍼센트	2
건강 팔찌와 목걸이가 효능이 있을까 	건강 팔찌 목걸이 효능 여부	0
급한 일이라 빠르면 빠를수록 좋은데 언제 가능해	가능한 시기	2
소민이 생일까지 언제지	소민이 생일	2
저번 주와 달라진 부분 있습니까 	저번 주와 차이점	2
작년 가을 유행에 관련된 기사는 있니	작년 가을 유행 관련 기사	2
그 건물을 아예 폐쇄했어	그 건물 아예 폐쇄했는지	0
국민은행에서 뽑으려면 수수료 나가	국민은행에서 뽑으면 수수료 있는지	0
절대 안돼	절대 안되는지	0
돈을 은행에 넣을까 아니면 그냥 가지고 있을까	돈을 은행에 넣을지 가지고 있을지	1
교통비를 절약할 수 있는 가장 좋은 방법이 뭐야 	교통비 절약 방법	2
몇시에 볼까	보는 시각	2
용산 주변 휴대폰 대리점은 어떻게 가	용산 주변 휴대폰 대리점 가는 방법	2
주식 매수 선택권의 부여 방법은 뭐야	주식 매수 선택권 부여 방법	2
오늘의 금리는 어떻게 될까	오늘 금리 전망	2
우리학교 종례시간이 언제야	우리학교 종례시간	2
주식형 펀드와 적금 중에 뭘 하는게 좋을까	주식형 펀드 적금 중 할 만한 것	2
독감 예방 주사는 맞았니 	독감 예방주사 맞았는지	0
아기 침대 취소해	아기 침대 취소할지	0
이번 주 전국 예상 날씨는 어떻데니	이번 주 전국 예상 날씨	2
유레일 패스로 갈 수 있는 국가가 어디니	유레일 패스 갈 수 있는 국가	2
원래 귀가차량이 많은 거야	원래 귀가차량 많은지	0
자동차세 마감일이 무슨요일이지	자동차세 마감일 요일	2
어젯밤에 온 새 메일은 몇 통이냐	어젯밤에 온 새 메일 수	2
원서 접수가 이번 주까지야	원서 접수 기한 이번 주인지	0
다음 주 화요일 바다날씨가 어때	다음 주 화요일 바다날씨	2
강변북로에 고장 차량이 있니	강변북로 고장 차량 있는지	0
날씨가 춥고 바람이 많이 부는데 배가 출항 할 수 있을까	출항 가능 여부	0
주가가 꽤 높은데 적립식 펀드 같은 곳에 가입해도 될까	적립식 펀드 가입해도 될지	0
서울 부산 고속철 운임 얼마해	서울 부산 고속철 운임	2
거래소와 코스닥이 뭐가 다른거야	거래소 코스닥 차이점	2
부산시 진입로 지체구간은 어떨지	부산시 진입로 지체구간 상태	2
부산의 명동칼국수는 어디니	부산 명동칼국수 위치	2
왜 약속을 할 땐 항상 새끼손가락을 거는 걸까 	약속 새끼손가락 거는 이유	2
잘 지내는지 궁금하네	잘 지내는지	0
당뇨병은 불치병이라던데 그거 정말이야 	당뇨병 불치병 여부	0
해외 송금 아무 은행에서나 가능한 거니	해외 송금 아무 은행에서나 가능한지	0
오늘 새 법률안 통과됐대	오늘 새 법률안 통과됐는지	0
요금조정을 요청했는데 왜 처리가 안되지 	요금조정 요청 처리 안되는 이유	2
이번 학기에 몇 학점 수강 신청했어 	이번 학기 수강 신청 학점 수	2
지금 도착해	지금 도착하는지	0
어젯밤 보낸 이메일 중 송신 확인 안 된 이메일 얼마나되	어젯밤 보낸 이메일 중 송신 확인 안 된 이메일 수	2
인터넷 쇼핑몰에서 사고 실시간 계좌 이체했어	인터넷 쇼핑몰 실시간 계좌 이체 했는지	0
엄마 아빠 결혼기념일이 언제야	엄마 아빠 결혼기념일	2
우리 학교 전용 거래 은행은 우체국이지	우리 학교 전용 거래 은행 우체국인지	0
야간 기차를 예약할래	야간 기차 예약할지	0
청소년 주식투자를 지원하는 학생들 클럽이 있나요 	청소년 주식투자 지원 학생 클럽	2
고속도로가 빠를까 국도가 빠를까	고속도로 국도 중 빠른 것	1
그 가수 콘서트는 야외공연 이야	그 가수 콘서트 야외공연인지	0
그 남자친구랑 아직도 안 깨지고 사귀고 있니	그 남자친구 아직 사귀는지	0
전문가들은 왜 안 사나요	전문가들 안 사는 이유	2
대림산업의 어제 주가급등의 이유는 뭡니까	대림산업 어제 주가급등 이유	2
레저 스포츠의 종류에 대해서 알고 싶어요	레저 스포츠 종류	2
건강은 좀 어떠세요 푹 좀 쉬셨어요 	푹 쉬었는지	2
자격증 따려고 하는데 뭐가 좋을까	따기 좋은 자격증	2
곧 유학 간다는 소문이 사실이야 	유학 가는지	0
방학기간이 얼마나 되지	방학 기간	2
인터넷 증권회사가 있던데 뭐가 좋을까	좋은 인터넷 증권회사	2
현금 서비스 이자율 얼만지 알고 있어	현금 서비스 이자율	2
정선수 삼 라운드까지 사 위였는데 마지막 라운드에서 어떻게 됐습니까	정선수 마지막 라운드 상황	2
이번 프로젝트 종료일이 언제야	이번 프로젝트 종료일	2
전에 이야기했던 식사대접을 오늘 해도 되려 나요	오늘 식사대접 가능 여부	0
호와 원주율에 관한 원 공식을 알고 싶어	호 원주율 원 공식	2
국어 수업시간이 이번 주에 몇 번있지	이번 주 국어 수업시간 수	2
급행 요금은 얼마에요	급행 요금	2
작년 가을 유행에 관련된 기사는 있니	작년 가을 유행 관련 기사 여부	0
농협에서 대구 은행으로 계좌 이체 시키는데 수수료 얼마야	농협에서 대구은행으로 계좌 이체 수수료	2
노량진의 바닷가재 요리 전문점은 어떻게 가	노량진 바닷가재 요리 전문점 가는 방법	2
일박에 얼마나 하니	일박 가격	2
좀 싼 호텔 있나요	싼 호텔 있는지	0
서태지 콘서트가 언제 하는데	서태지 콘서트 날짜	2
실업급여 신청일이 언제까지지	실업급여 신청 기한	2
전화도 안 받고 한 시간 후면 시험인데 왜 안 오는 거야	안 오는 이유	2
생명보험의 원금 회수율은 보통 얼마나 될까	생명보험 원금 회수율	2
회원가입 약관에 동의하십니까	회원가입 약관 동의 여부	0
한남대교 북단은 상습 정체구간이냐	한남대교 북단 상습 정체구간 여부	0
어디야 지금	현재 위치	2
개인통장이야 법인 통장이야	개인통장인지 법인통장인지	0
티브이에 너 나온 것 보고 연락 하는 거야 잘 지내니 	잘 지내는지	0
이제 휴대폰으로도 은행업무 가능해	휴대폰 은행업무 가능 여부	0
오늘 계약 한 건 했다 뭐 먹고 싶어 	먹고 싶은 것	2
끝났어	끝났는지	0
아홉시 출발은 몇 시 도착이래	아홉시 출발 도착 시각	2
첫 월급은 어느 계좌로 입금해야 하나요 	첫 월급 입금 계좌	2
삼십일에 유원지 갈 거야	삼십일 유원지 갈지	0
추석 예매 기간이 언제부터인지 알아 	추석 예매 기간	2
컴퓨터 고장 났다며 고쳤어 	컴퓨터 고쳤는지	0
정말 사랑하니	정말 사랑하는지	0
여기서 기다릴까	여기서 기다릴지	0
지금 집에 누가 있지	지금 집에 있는 사람	2
우리 학교 학생증도 체크카드야	우리 학교 학생증 체크카드인지	0
유통관리사 시험공부 중인데 따 놓으면 도움이 될까 	유통관리사 자격증 도움 여부	0
내일 광안리의 해수 온도는 어떻지	내일 광안리 해수 온도	2
공부 다 했어	공부 다 했는지	0
컴퓨터에 바이러스 걸렸어	컴퓨터 바이러스 걸렸는지	0
세미나는 무슨 요일에 있지	세미나 요일	2
금일 주가에 영향을 미칠만한 정치적인 일들은 뭐가 있어	금일 주가 영향 미칠만한 정치적인 일들	2
다시 한 번 체크할 수 있을까요	다시 한 번 체크 가능 여부	0
건강은 좀 어떠세요 푹 좀 쉬셨어요 	건강 어떤지	0
병원에 입원 하셨다면서요 언제 퇴원하시는지요 	퇴원 일자	2
너 재테크 어떻게 하고 있어 	재테크 방법	2
해외 송금은 어떻게 하는 거야	해외 송금 방법	2
네가 말한 물품이 없는데 그거 꼭 가지고 가야 해 	물품 꼭 가지고 가야 하는지	0
여기 은행통장 만들어 봤니 나 만들려고 하거든	은행통장 만들어 봤는지	0
사업컨설팅을 어디에 맡겨야 하나 	사업컨설팅 맡길 곳	2
시험 범위가 어디까지지	시험 범위	2
팔월 십사일이 일요일이야	팔월 십사일 일요일인지	0
통로 쪽 좌석만 있었어	통로 쪽 좌석만 있었는지	0
어제 몇 포인트로 마감되었어	어제 마감 포인트	2
지하철 몇 호선 타는 게 빨라 	가장 빠른 지하철 호선	2
설경구랑 정준호내일 대구 온데	설경구랑 정준호내일 대구 오는지	0
내시경 찍었다며 어떻다는데 위염이라고 	내시경 결과	2
은행주와 기술주가 유리할까 	은행주 기술주 유리할지	0
어떤 쇼가 있나요	쇼 종류	2
술 먹었어	술 먹었는지	0
이번 달에 정윤이로부터 이메일이 몇 통왔지	이번 달 정윤이로부터 온 이메일 수	2
전국적으로 장마야	전국적 장마인지	0
이번 새내기들 중에 예쁜 애들 많아	이번 새내기들 중 예쁜 애들 많은지	0
사람들은 왜 주식을 사는 것일까 	사람들 주식 사는 이유	2
조만간 부실회사로 분류될 것 같아	조만간 부실회사로 분류될 것 같은지	0
사당 역 육 번 출구로 나와서 걷고 있어	사당 역 육 번 출구로 나와서 걷고 있는지	0
한달 삼백만원 정도의 금액을 어떻게 저축하면 좋을까요	한달 삼백만원 저축 방법	2
독일의 맥주축제 기간은 언제냐	독일 맥주축제 기간	2
그런데 은행이 부도나면 내 돈은 어떡해	은행 부도나면 돈 어떻게 되는지	2
학교 주변에 이비인후과 어디 있나요	학교 주변 이비인후과 위치	2
혹시나 저축 은행이 망해도 원금을 보장 받을 수 있나요 	저축 은행 망해도 원금 보장 되는지	0
지선이와 약속시간이 언제지	지선 약속시간	2
월간지가 좋을까 주간지가 좋을까	월간지 주간지 중 좋은 것	1
성북구 길음동 근처 햄버거 어디에 있어	성북구 길음동 근처 햄버거 위치	2
바비큐 구워 먹을 곳은 있겠지 	바비큐 구워 먹을 곳 있을지	0
어른 둘이요	어른 둘인지	0
고려대 앞 대형 서점은 어떻게 간데	고려대 앞 대형 서점 가는 방법	2
차안에서 뭐 먹으면 안돼	차내 금식 여부	0
분당선 타려면 어느 역에서 타야 하니 	분당선 타는 역	2
외국 계열의 보험회사가 괜찮다고 들었는데 어때	외국 계열 보험회사 괜찮은지	0
그 헬스클럽이 회비가 저렴 해	그 헬스클럽 회비 저렴한지	0
삐졌어	삐졌는지	0
왕십리에서 제일로 맛나는 냉면집은 어디냐	왕십리 맛나는 냉면집	2
열이 많이 나요	열 많이 나는지	0
오 번 플랫폼은 어디에요	오 번 플랫폼 위치	2
주식에서 말하는 액면가는 무엇을 의미합니까	주식 액면가의 의미	2
우리 이번 주 금요일에 보는 거지 	이번 주 금요일 보는지	0
시험 전에 요점 정리하고 있는 거야	시험 전 요점 정리하는지	0
오늘 가정 실습은 탕수육 만드는 거래	오늘 가정 실습 탕수육 만드는지	0
영어 인터뷰 연습할 상대를 구하는데 적당한 사람 있을까 	영어 인터뷰 연습 적당한 상대	2
우리 마누라 생일이 언제지	우리 마누라 생일	2
거기서 유턴 되는지 모르겠네	거기서 유턴 가능 여부	0
요가가 살 빼는 데 효과가 있을까 	요가 살 빼는 데 효과 있는지	0
자동차 정기 검사일은	자동차 정기 검사일	2
네트워크 상에 문제가 생겼어	네트워크 상 문제 여부	0
내일부터 우리 죽음의 다이어트 시작하는 거야	내일부터 다이어트 시작하는지	0
걔는 약속 시간보다 맨날 늦게와	걔 약속 시간보다 맨날 늦게 오는지	0
리포트 자료 어디서 찾는 게 좋을까	리포트 자료 찾을 곳	2
보고서는 다음 주까지야	보고서 다음 주까지인지	0
요즘 잘나가는 모델의 차가 뭐 있지	요즘 잘나가는 모델 차	2
아침 자율 학습 하기 싫어	아침 자율 학습 하기 싫은지	0
오늘 모임에 참석할 건가요	오늘 모임 참석 여부	0
키아누 리브스 나오는 그 영화도 매진이야	키아누 리브스 나오는 영화 매진인지	0
비만 오면 왠지 우울하고 찝찝하다 왜 이럴까	비 오면 우울 찝찝한 이유	2
동창회를 하는데 그 많은 사람들이 어디서 모이지 	동창회 사람들 모일 장소	2
학교 수영장 자유수영 어때	학교 수영장 자유수영 어떤지	0
서울대학교 근처 노래방은 어디래	서울대학교 근처 노래방 위치	2
요즘 사업은 어떠십니까	요즘 사업 상태	2
해외에 돈을 보내야 하는데 처음이라 모르겠어	해외 돈 보내는 방법	2
혈압 올라가면 위험해요	혈압 올라가면 위험한지	0
신용카드공제를 받을 수 있나요 	신용카드공제 받을 수 있는지	0
내년 겨울의 예상 강우량은	내년 겨울 예상 강우량	2
삼계탕이 더 좋을까 보신탕이 더 좋을까 	삼계탕이 좋을지 보신탕이 좋을지	0
서류 오늘까지 주기로 한 게 맞아	서류 오늘까지 주는지	0
혜화역까지 삼십 분만에 갈 수 있다구	혜화역까지 삼십 분만에 갈 수 있는지	0
어제 보낸 메일 중 수신이 확인된 메일 몇 통이래	어제 보낸 메일 중 수신 확인된 메일 수	2
수학 과외하면 성적 올릴 수 있을까	수학 과외 성적 상승 여부	0
어젯밤 이메일 중 첨부 파일이 든 이메일이 있지	어젯밤 이메일 중 첨부 파일 든 이메일	2
강릉 삼박 사일 코스는 얼마니	강릉 삼박 사일 코스 가격	2
살이 찌니까 관절에 무리가 와	관절 무리 오는지	0
아마추어가 투자에 성공하는 비결은	아마추어 투자 성공 비결	2
현대증권과 한양증권 중 어느 것이 수수료가 싸나요	현대증권 한양증권 중 수수료 싼 것	1
야간 자율학습 신청 할 꺼야 	야간 자율학습 신청 할지	0
돈을 벌려면 부동산 투자가 좋을까요 증권 투자가 좋을까요	부동산 투자 증권 투자 중 돈 벌기 좋은 것	1
부산대 앞 쥬얼리는 어디에 있지	부산대 앞 쥬얼리 위치	2
동아대 근처 많이 가는 밥집은 어떻게 갈까	동아대 근처 많이 가는 밥집 가는 방법	2
모레 경주지역의 비가 내릴 확률은	모레 경주지역 비 내릴 확률	2
계단 오를 때 숨이 쉽게 차니	계단 오를 때 숨이 쉽게 차는지	0
영화 보러 갈까	영화 보러 갈지	0
나의 목표를 빨리 이룰 수 있도록 도움을 줄 수 있는 것은 뭘까 	목표 달성 도움 주는 것	2
이번에 씨이오가 바뀐다던데 누가 될까 	씨이오 정체	2
논술은 학습지가 날까 학원이 날까	논술 학습지 학원 중 나은 것	1
중복이 언제지	중복 날짜	2
일본어를 배울까 중국어를 배울까	일본어 중국어 중 배울 것	1
어제 일기도가 어땠니	어제 일기도	2
체육시간에 다리를 다쳤어	체육시간 다리 다쳤는지	0
열두시 이후에 보낸 메일이 몇 개나 있지	열두시 이후 보낸 메일 수	2
다른 나라들의 포인트와 절대비교가 가능한가요	다른 나라들의 포인트와 절대비교 가능 여부	0
자동차 정비 검사일이 언제지	자동차 정비 검사일	2
인터넷 증권회사가 있던데 뭐가 좋을까	괜찮은 인터넷 증권회사	2
오늘 회의 때 뵐 수 있을까요	오늘 회의 때 볼 수 있을지	0
강남에 분위기 좋은 바가 있데 	강남 분위기 좋은 바	2
어떤 비행기편을 탈 수 있나요	가능한 비행기편	2
오늘 배드민턴 경기에 관한 기사가 있어	오늘 배드민턴 경기 관한 기사	2
대출 하려고 하는데 유가증권 담보도 가능한가요	대출 유가증권 담보 가능 여부	0
오늘 새 편지 중 정미가 보낸 메일이 몇 통이냐	오늘 새 편지 중 정미가 보낸 메일 수	2
고속도로와 국도중 어느 길이 낫지	고속도로 국도 중 나을 곳	1
동대문에서 제일 싼 술집 어디일까	동대문에서 제일 싼 술집	2
성함과 방 번호가 어떻게 되시나요	성함 방 번호	2
대한항공 요금이 얼마야	대한항공 요금	2
뒤에서 무릎 구부릴 때 찍은 사진 가지고 계세요	뒤에서 무릎 구부릴 때 찍은 사진 있는지	0
언니는 네 시쯤 들어가	네 시쯤 들어가는지	0
비행기 표는 예약 해 뒀니	비행기 표 예약 여부	0
이 투어는 얼마죠	투어 가격	2
청량리역 지상 역으로 가야 돼 아니면 지하로 가야 돼	청량리 지상 지하 중 갈 곳	1
내일 아침 여덟시 경에 서울에서 부산에 가는 비행기가 있나	내일 아침 여덟시 서울에서 부산 가는 비행기 여부	0
할머니 건강하시죠 곧 찾아 뵐게요	건강하신지	0
정액권이 한 이만오천원인가 십 회 자유수영	정액권 가격	2
학칙 개정안 결국 무효화 되었대	학칙 개정안 결국 무효화 되었는지	0
원서 접수가 이번 주까지야	원서 접수 이번 주까지인지	0
교수님이 식사 같이 하자시던데 시간 괜찮아	교수님과 식사 시간 괜찮은지	0
보낸 이메일 중 되돌아 온 이메일 몇 통인가	보낸 이메일 중 되돌아온 이메일 수	2
양파는 원래 익혀도 영양소가 파괴가 되지 않아	양파는 익혀도 영양소 파괴되지 않는지	0
모레 경주지역의 비가 내릴 확률은	모레 경주지역 비 내릴 확률	2
세느강 크루즈는 어떤 게 있나요	세느강 크루즈 종류	2
그때 그 사람 스킨스쿠버 강사라고 했었지	그 사람 스킨스쿠버 강사 여부	0
오늘 가져다주기로 하고선 왜 또 안 된다 그래 	안 가져다주는 이유	2
다음 주 전국 예상날씨는 어떠니	다음 주 전국 예상날씨	2
개인통장이야 법인 통장이야	개인통장인지 법인 통장인지	0
보낸 이 이름이 영어로 된 메일 있지	보낸 이 이름 영어 메일	2
소림사에 인접한 절이 어디니	소림사 인접한 절	2
어디에 줄 서면 되죠	줄 설 곳	2
증권시장에서 지난 옵션 가격을 행사가 별로 알 수 있을까 	증권시장 지난 옵션 행사가 별 가격	2
자격증 따려고 하는데 뭐가 좋을까	따기 좋은 자격증	2
무지개 그 쪽 동네에도 떴니 너무 예쁘다	무지개 그 쪽에도 떴는지	0
그만큼 위험하기도 한 거야	위험한지	0
임용고시 준비는 잘 되가	임용고시 준비 잘 되가는지	0
뭐하고 지내느라 연락도 안하냐	뭐하고 지내는지	2
일 년에 연차는 며칠이나 쓸 수 있죠	일 년 연차 일수	2
지금 강변도로 쪽에 정체가 심하니	지금 강변도로 쪽 정체 정도	2
영미가 보낸 메일 있니	영미가 보낸 메일 있는지	0
이 열차는 몇 번 플랫폼에서 출발해요	열차 출발 플랫폼	2
토익 육십점 넘어야 졸업 가능해	토익 육십점 넘어야 졸업 가능한지	0
경락 마사지 받으면 효과는 좀 있어 	경락 마사지 효과 여부	0
엘리베이터보다는 계단을 이용해	엘리베이터보다 계단 이용하는지	0
자외선을 피부에 직접적으로 받으면 좋지 않아	자외선 피부 직접 받으면 좋은지	0
서울에 특산품 판매점 많데	서울에 특산품 판매점 많은지	0
기름 경고등 불 켜지고 나서 얼마나 탈수 있지	기름 경고등 후 가능 거리	2
초등학교 동창회 압구정에서 한데	초등학교 동창회 압구정에서 하는지	0
미 상공회의소 회장과 인터뷰 기사 뭐야	미 상공회의소 회장 인터뷰 기사	2
이 근처에서 제일 유명한 데는 어디에요	이 근처 제일 유명한 곳	2
그래서 늦을 것 같아	늦는지	0
비행기표 미리 구해 놨어 	비행기표 미리 구해 놨는지	0
빌라는 잘 안 팔려 아파트 살 거야	아파트 살지	0
주식투자를 시작할 때 제일 먼저 할 일은	주식투자 제일 먼저 할 일	2
중간고사일이 언제야	중간고사일	2
명동 부근 주차장은 어디에 있데	명동 부근 주차장 위치	2
요가 배우니까 몸이 좀 더 유연해지는 것 같아	요가 배우면 몸 더 유연해지는지	0
광명역 근처 독일 레스토랑 어떻게 간데	광명역 근처 독일 레스토랑 가는 방법	2
이번 달 정수기필터 교체일이 언제지	이번 달 정수기필터 교체일	2
오늘 충전상태는 얼마나 되어있지	오늘 충전상태	2
부대찌개에 넣을 재료 뭐 필요해	부대찌개 재료	2
부산에서 서울 간 케이티엑스 특실 가격은	부산 서울 간 케이티엑스 특실 가격	2
가장 최근에 정윤이랑 만난 날이 언제지	가장 최근 정윤이랑 만난 날	2
그 헬스클럽 괜찮아	그 헬스클럽 괜찮은지	0
프랑스의 화폐가 뭐니	프랑스 화폐	2
잘 지내는지 궁금하네	잘 지내는지	0
우리 시험 끝나면 뭐하고 놀까 	시험 끝나면 하고 놀 것	2
수업분위기도 살벌해	수업분위기 살벌한지	0
이체 수수료 어느 은행이 싸	이체 수수료 싼 은행	2
왜 여자들은 결혼하면 회사를 그만두라고 하지	여자들 결혼하면 회사 그만두라는 이유	2
사랑니는 무사히 뺐나요	사랑니 무사히 뺐는지	0
오늘 오후에 도착한 메일 몇 통이래	오늘 오후 도착 메일 수	2
대구 몇 시에 도착이야	대구 도착 시간	2
오늘 학교에서 영화촬영 했어	오늘 학교 영화촬영 했는지	0
학교버스가 얼마나 자주 있지	학교버스 주기	2
다음 명절이 언제니	다음 명절 날짜	2
주식 계좌 이체도 예금의 현금이체와 동일해	주식 계좌 이체와 예금 현금이체 동일한지	0
막내가 외갓집에 가기로 한날이 얼마나 남았지	막내가 외갓집에 갈 때까지 기간	2
허브를 종류별로 다 샀어	허브 종류별로 다 샀는지	0
요번 주의 전국 날씨 어떤데	요번 주 전국 날씨	2
일 주일에 두 번 예금 하고 있어	일 주일 두 번 예금 하고 있는지	0
내일 배울 것 예습 다 했어 	내일 배울 것 예습 다 했는지	0
마장동에서 유명한 해장국밥집 어디지	마장동 유명한 해장국밥집	2
오늘 스팸 메일 몇 통 왔니	오늘 스팸 메일 수	2
어젯밤 새 메일 중에 정자 아이디로 된 이메일이 있니	어젯밤 새 메일 중 정자 아이디로 된 이메일	2
서울 가는 버스에서 뭐 했어	서울 가는 버스에서 한 것	2
너는 왜 통장 비밀번호랑 카드 비밀번호랑 똑같지	통장 비밀번호 카드 비밀번호 똑같은 이유	2
날씨에 가장 영향을 많이 받는 직업은 뭘까 	날씨 가장 영향 많이 받는 직업	2
이번 학기에는 몇 학점을 들을 예정이니 	이번 학기 학점 수	2
네 시 어떠세요	네 시 어떤지	0
기획 특집 업무는 퀄리티가 떨어지나요 	기획 특집 업무 퀄리티가 떨어지는지	0
요가를 시작한다고 하던데 왜 나는 불러주지 않았어 	요가 시작에 부르지 않은 이유	2
요즘 외국인들이 한국 주식을 파고 있는 이유가 뭘까 	요즘 외국인들 한국 주식 파는 이유	2
서울시에서 하는 간선 버스와 지선 버스는 무엇입니까 	서울시 간선 버스 지선 버스	2
선생님의 안부가 궁금한데 연락할 방법이 없을까 	선생님 연락 방법	2
정말 아팠어	정말 아팠는지	0
금연하고 싶어	금연하고 싶은지	0
해운대 근처 당구장 어떻게 가냐	해운대 근처 당구장 가는 방법	2
심장병이 있는지 몰랐어	심장병 있는지 몰랐는지	0
주식을 양도 받으려는데 이 주식 괜찮을까 	주식 양도 괜찮을지	0
적금을 들을까 보험을 들을까	적금 보험 중 들 것	1
통장에서 돈이 빠져 나갔어	통장에서 돈 빠져 나갔는지	0
문화원 강좌는 시험 봐서 들어가는 거야	문화원 강좌 시험 봐서 들어가는지	0
배 아파	배 아픈지	0
요즘 건강은 어떠십니까	요즘 건강 상태	2
부모님 걱정 많이 하시지 몸 아픈 것도 불효야	부모님 걱정 많이 하시는지	0
너 나의 외식 사업에 투자할 생각은 없어 	나의 외식 사업 투자 생각 없는지	0
이름을 몰라서 여쭤봅니다	이름	2
다 왔니 얼마나 더 기다려	다 왔는지	0
어떻게 하면 빨리 읽을 수 있지	빨리 읽는 방법	2
일 도와주겠다는 것 유효하지 	일 도와주겠다는 것 유효 여부	0
내후년 대선에 관한 새로운 소식 나왔니	내후년 대선 새로운 소식 여부	0
내일 현준이와 몇 시에 만나기로 했지	내일 현준이 만나는 시각	2
부동산 가압류와 근저당 설정 중 어떤 게 우선순위 인가요	부동산가압류 근저당설정 중 우선순위인것	1
사촌누나 결혼식이 며칠이지	사촌누나 결혼식 날짜	2
성인 요금 얼마니	성인 요금	2
아르바이트 월급 받아서 뭐 할거야 	아르바이트 월급으로 할 것	2
혹시 요즘 여윳돈 좀 있으면 주식투자 좀 해볼래 	주식투자 해볼지	0
부산 시내 지체구간 얼마나 되니	부산 시내 지체구간 정도	2
주가가 폭락했는데 그 원인은 무엇인가요 	주가 폭락 원인	2
입추가 언제지	입추 날짜	2
사진은 언제 다 되나요	사진 완성 시기	2
크리스마스 날 가기로 한 곳 예약해놨어	크리스마스 날 가기로 한 곳 예약해놨는지	0
코스닥 등락폭이 컸다는 데 그 이유가 뭘까 	코스닥 등락폭 큰 이유	2
막내 약혼식 시간은 언제일까	막내 약혼식 시간	2
현재 전국 풍량은 얼마나 되니	현재 전국 풍량	2
오랜만에 햇살도 나서 이불 말리고 있어 너는 뭐해	지금 하는 것	2
미선엄마 오늘 천삼호에서 반상회 있어	오늘 천삼호 반상회 있는지	0
해외여행 때는 신용카드가 더 편해	해외여행 신용카드 더 편한지	0
불멸의 이순신 언제 시작하는데	불멸의 이순신 시작 시각	2
오늘 과외 토요일로 미뤄졌어	오늘 과외 토요일로 미뤄졌는지	0
용돈이 통장에 안 들어왔어	용돈 통장에 들어왔는지	0
그냥 지하철 타고 가면 되요	지하철 타고 가면 되는지	0
서초동 동사무소는 어떻게 간데	서초동 동사무소 가는 방법	2
친구들은 많이 사귀었어	친구들 많이 사귀었는지	0
나도 그 회사 주식 몇 주 보유하고 있는데 어쩔까 	회사 주식 보유 상황 대책	2
오늘 서울의 오존 지수는	오늘 서울 오존 지수	2
경부 고속도로 노면 결빙 구간은 어떨까	경부 고속도로 노면 결빙 구간 상태	2
혹시 친구들이랑 싸운 거니 	친구들과 싸웠는지	0
투자할 때 제일 먼저 고려돼야 할 사항은 뭐지 	투자 제일 먼저 고려할 사항	2
요즘 외국계 보험 회사들이 많아	요즘 외국계 보험 회사들 많은지	0
성서 사 차 단지에 유월에 입주하는 거 맞죠	성서 사 차 단지 유월 입주 맞는지	0
여기서 가려면 어떻게 가야 가장 빠른데 	여기서 가는 가장 빠른 방법	2
주식이란 정확히 무엇을 말하는 거니 	주식 의미	2
택시는 미터기의 요금만 내면 돼	택시는 미터기 요금만 내면 되는지	0
건조주의보 내린다는데 나도 가습기나 하나 살까	나 가습기 살지	0
해외 영업 업무에 지원해 볼 거야	해외 영업 업무 지원해 볼지	0
재무구조가 확실한 회사야	재무구조 확실한 회사인지	0
수신 확인이 된 새 메일 몇 통이데	수신 확인 된 새 메일 수	2
학습 효과가 뛰어날 수 있게 하려면 어떻게 해야 할까 	학습 효과 증진 방법	2
감기 걸렸음	감기 걸렸는지	0
꽃꽂이 수강생들에게 편지 보내	꽃꽂이 수강생들에게 편지 보내는지	0
너 적금통장 가지고 있어	적금통장 가지고 있는지	0
철수기업의 유장증자의 가격이 어떻게 됩니까	철수기업 유장증자 가격	2
토큰은 어디서 파나요	토큰 파는 곳	2
광명역 근처 독일 레스토랑 어떻게 가니	광명역 근처 독일 레스토랑 가는 방법	2
어젯밤 이메일 중 첨부 파일 든 이메일은 얼마나 되냐	어젯밤 이메일 중 첨부 파일 든 이메일 수	2
어떻게 공부해야 토익 만점이 나올까 	토익 공부법	2
어떤 비행기편을 탈 수 있나요	탈 수 있는 비행기편	2
일 사용료 얼마야	일 사용료	2
오늘의 헤드라인 기사 뭐야	오늘 헤드라인 기사	2
화랑로 월곡 방향은 흐름이 원활해	화랑로 월곡 방향 흐름 원활 여부	0
저번 달 휴가가 언제였지	저번 달 휴가일	2
사장님께서 웹하드에 다 올려 놓으셨데요	사장님께서 웹하드에 다 올려 놓으셨는지	0
시골에 가는데 버스가 빠를까 기차가 빠를까	시골 가는데 버스 기차 중 빠른 것	1
허리 다쳤어	허리 다쳤는지	0
외국인들이 매수 우위를 보이는 주식이 유망해요	외국인 매수 우위 주식 유망 여부	0
이번 주 전국 예상 날씨는 어때	이번 주 전국 예상 날씨	2
다음 시간에 야외 수업 한대	다음 시간 야외 수업 여부	0
인터넷 뱅킹 신청하려면 뭐 뭐 필요해 	인터넷 뱅킹 신청 필요한 것	2
우리 회사 어음 꽤 많이 끊었던데 괜찮을까	회사 괜찮을지	0
한여름에 눈이 내릴 확률은	한여름 눈 내릴 확률	2
학교 가기 싫어	학교 가기 싫은지	0
친구중에 은행다니는 애 없냐 대출좀 알아보게	은행 다니는 친구 있는지	0
유월 이십일까지 끝내야 돼	유월 이십일까지 끝내야 되는지	0
적금 통장 하나 만들어볼까	적금 통장 만들지	0
조정 때 미리 사 두는 게 괜찮아	조정 때 미리 사 둘지	0
저녁에 인출 수수료는 얼마니	저녁 인출 수수료	2
점심은	점심 먹었는지	0
왜 비가 오면 운전하는 것이 위험할까	비 오면 운전 위험한 이유	2
청담동 건은 어떻게 됐어 잘됐어	청담동 건 진행 상황	2
오늘 주식 올랐어	오늘 주식 올랐는지	0
올해 우박이 심하게 발생할 확률은 얼마나 되지	올해 우박 심하게 발생할 확률	2
레저용 자동차에는 뭐 뭐가 있어 	레저용 자동차 종류	2
그 곳 날씨는 어때 여기는 매우 안 좋아	그 곳 날씨	2
신뢰도가 제일금융권이 좋을까 아니면 제이 금융권이 좋을까	제일금융권 제이금융권 중 신뢰도 좋은 것	1
버스와 지하철 중에서 뭘 이용할 거니 	버스 지하철 중 이용할 것	1
너 옛날에 밴드 했었는데 아직도 하니 	아직 밴드 하는지	0
무역회사에서 주로 하는 업무는 무엇입니까	무역회사 주로 하는 업무	2
현재 태풍 주의보 내려진 지역 어디지	현재 태풍 주의보 내려진 지역	2
양산 나들목에 정체가 심한지 알자	양산 나들목 정체 심한지	0
요즘에 차 유지비 많이 나가니  	요즘 차 유지비 많이 나가는지	0
한의원이 나을까 그냥 병원이 나을까	한의원 병원 중 나은 것	1
기억은 되돌아 온거야 괜찮니	기억 되돌아왔는지	0
주가 차트 어떻게 읽는 거냐	주가 차트 읽는 방법	2
한양대학교 학위 수여식이 언제지	한양대학교 학위 수여식	2
대출 상품이 많기는 한거 같은데 나한테 맞는 게 뭐가 있을까	나한테 맞는 대출 상품	2
현금카드랑 직불카드중 어느 것으로 할까	현금카드 직불카드 중 할 것	1
청약저축은 어느 은행에서 하던 다 똑같은 건가 	청약저축 은행 차이 여부	0
그 카드 유효 기간 지났어	그 카드 유효 기간 지났는지	0
단체 요금은 더 저렴해	단체 요금 더 저렴한지	0
추석날 경부 고속도로 지체 구역은	추석 경부 고속도로 지체 구역	2
서초 일동에 있는 호프집은 어떻게 가는가	서초 일동 호프집 가는 방법	2
왜 추운데 아이스크림 생각이 나는 걸까 	추운데 아이스크림 생각 나는 이유	2
거기 가려면 몇 호선 타야 돼 	거기 가려면 타야 하는 호선	2
요새 펀드도 투자 많이 하던데 뭐 그런 건 어때	펀드 투자 어떤지	0
거기서 지금 주도주 매매 수익율 공개하고 있어	주도주 매매 수익율 공개 여부	0
우리 병원까지 택시 타고 갈까 버스 타고 갈까	우리 병원까지 택시 버스 중 타고 갈 것	1
스노보드 위험하진 않아	스노보드 위험하진 않은지	0
같이 있어	같이 있는지	0
일은 할 만하니 사진 보니까 무척 야위었더라	일 할 만한지	0
다른 은행으로 계좌이체 하면 수수료 붙는 거야	다른 은행으로 계좌이체 수수료 여부	0
회신 메일은 얼마나 돼	회신 메일 양	2
민호 오월 달에 결혼한데	민호 오월 달 결혼여부	0
저녁 먹는 거냐 마는 거냐 연락도 없고 	저녁 먹는지	0
윤희와 만나기로 한 날짜가 언제지	윤희 만나기로 한 날짜	2
새로 생긴 자마이카 휘트니스 어때	자마이카 휘트니스 어떤지	2
부천 국제 영화제는 언제 시작해	부천 국제 영화제 시작 날짜	2
정관이에게서 새로 온 메일이 있니	정관이에게 새로 온 메일 있는지	0
담배 피워	담배 피우는지	0
신용카드는 직장이 있어야 만들 수 있어	신용카드 직장 필요 여부	0
워크숍 준비 열심히 하고 있어요 	워크숍 준비 열심히 하고 있는지	0
새 편지 중 성인광고 단어가 든 메일 얼마나 된데	새 편지 중 성인광고 단어가 든 메일 수	2
한남대교 북단 상습 정체구간일까	한남대교 북단 상습 정체구간 여부	0
현재 황사 주의보 내려진 지역은 얼마나 돼	현재 황사 주의보 지역 수	2
주식가격변동이 기업가치에 미치는 영향이 큰가요	주식가격변동 기업가치 영향 큰지	0
필기도구 외에는 지참 못해	필기도구 외 지참 가능한지	0
화요일만 빼고 다른 날은 다 괜찮아	화요일만 빼고 다른 날 괜찮은지	0
프로젝트 언제까지 마칠 수 있지	프로젝트 가능 기한	2
작은 언니 생일 언제야	작은 언니 생일	2
현재 전국 고속도로의 날씨는	현재 전국 고속도로 날씨	2
지민이와 도자기 축제에 가기로 한 날이 언제야	지민이와 도자기 축제 가기로 한 날	2
부산대 앞 쥬얼리는 어디에 있데	부산대 앞 쥬얼리 위치	2
교양 과목을 최소 몇 학점 들어야 하는 거야 	교양 과목 최소 학점 수	2
어젯밤 온 메일 중 첨부 파일이 든 메일 몇 통이니	어젯밤 온 메일 중 첨부 파일이 든 메일 수	2
스쿼시 육개월치 한꺼번에 끊으면 할인 많이 해줄까	스쿼시 육개월치 한꺼번에 끊으면 할인 많이 해줄지	0
내일 기온이 몇 도나 될까	내일 기온	2
레포트는 파워포인트로 작성 해야돼	레포트 파워포인트로 작성 해야되는지	0
너 어릴 때 태권도 배웠지	어릴 때 태권도 배웠는지	0
신도시 계획이 아직 영향을 미친것 같지는 않아	신도시 계획 영향 여부	0
그 친구 수시 합격했대	그 친구 수시 합격했는지	0
올 거야 말 거야	올 건지 말 건지	0
강남에 있는 고시원은 어떻게 간데	강남 고시원 가는 방법	2
울산에서 통도사 가는 국도에 주유소가 있나	울산에서 통도사 가는 국도 주유소 여부	0
말복이 얼마나 남았니	말복 남은 기간	2
장난이지	장난인지	0
취득세를 내려면 어디로 가야 합니까 	취득세 내는 곳	2
오늘 수업은 몇 시에 시작하지	오늘 수업 시작 시각	2
어젯밤 이메일 중 첨부 파일 든 이메일 얼마나 되냐	어젯밤 이메일 중 첨부 파일 든 이메일 수	2
너 예전에 나한테 한 약속은 벌써 까먹은 거지 	예전 약속 까먹었는지	0
건강식품이 정말 효능이 있나요 	건강식품 효능 여부	0
바퀴달린 건 다 잘타	바퀴달린 건 다 잘타는지	0
자동 인출기에서 뽑으면 수표 수수료 안 물어도 돼	자동 인출기에서 뽑으면 수표 수수료 안 물어도 되는지	0
부산에서 제일 큰 예식장은 어디니	부산 제일 큰 예식장	2
우리 누나 출산일이 언제인가	우리 누나 출산일	2
이번 귀성 길에는 버스 탈까 아니면 비행기 탈까	이번 귀성 길 버스 비행기 중 탈 것	1
우리 빼빼로데이에 만나서 놀까 	빼빼로데이에 만나서 놀지	0
장학금 받으려면 성적이 얼마나 되야 하지	장학금 가능 성적	2
예스 네요 튈까요 아님 착륙할까요 	튈지 착륙할지	1
이번에는 휴양지에서 쉬기로 했어요	이번에는 휴양지에서 쉬는지	0
청약저축은 어느 은행에서 하던 다 똑같은 건가 	청약저축 어느 은행이든 똑같은지	0
교수님 면담 약속은 잡았어	교수님 면담 약속 잡았는지	0
걔는 임용 시험 준비한대	걔 임용 시험 준비하는지	0
별일은 없고	별일 없는지	0
오늘의 주가는 어떻게 되니	오늘 주가	2
오늘 미팅이 몇 시에 있지	미팅 시각	2
오늘 새 편지 중 아이디 피그바라가 보낸 메일이 몇 통이지	오늘 새 편지 중 아이디 피그바라가 보낸 메일 수	2
다들 그래	다들 그런지	0
부산 지역 해수욕장의 수온은 얼마지	부산 지역 해수욕장 수온	2
차랑 기차 어느쪽이 더 빨라	차 기차 중 빠른 것	1
인철씨 지금 외근 나가셨어요 	인철씨 외근 나가셨는지	0
모두 잘 지내고 있어	모두 잘 지내는지	0
전기 검침일이 언제지	전기 검침일	2
병원에 가서 주사 맞을까 한의원에 갈까	병원 가서 주사 맞을지 한의원 갈지	1
거치식으로 할까 아니면 추가로 오백을 더 넣을까	거치식으로 할지 추가로 오백 더 넣을지	1
마일리지의 혜택이 줄어든데	마일리지 혜택 줄어드는지	0
예약금 걸 돈이 없는데 어쩌면 좋지	예약금 없을 때 대책	2
증권 시장에서 장외 시장이란 게 뭔 줄 아니	장외 시장 의미	2
오늘 그럼 송이언니도 같이 가도 되는 분위기야	송이언니 동행 가능 여부	0
추분 다음에 오는 절기가 뭐야	추분 다음 절기	2
내일 황사지수가 얼마나 되지	내일 황사지수	2
수철이가 걸린 병은 희귀병이래	수철이 걸린 병 희귀병인지	0
이번 헬스클럽 회원 만료일이 언제	이번 헬스클럽 회원 만료일	2
올해 한국어 정보처리 학회는 언제 시작인데	올해 한국어 정보처리 학회 시작 날짜	2
경북 부근에 눈썰매장은 어떻게 가는가	경북부근 눈썰매장 가는 방법	2
헬스 코치가 너 안 보인다고 묻던데 오늘 왜 안 왔어 	오늘 안 온 이유	2
오빠 모임 안 오신 거예요 스타벅스 핸드폰 줄 갖고 왔는데	모임 안 왔는지	0
언니 결혼한다고 소식있던데 언제쯤이야 	결혼 시기	2
프로농구 개막일이 언제야	프로농구 개막일	2
기차보다 더 빠른 게 비행기 맞니 	기차보다 더 빠른 게 비행기인지	0
경주 힐튼 호텔 예약할래	경주 힐튼 호텔 예약할지	0
예매 했어	예매 했는지	0
까쓰레인지 왼쪽 뒤 불 한 칸 낮추니	까쓰레인지 왼쪽 뒤 불 한 칸 낮추는지	0
경부 고속도로 정체구간 어떤데	경부 도속도로 정체구간 상태	2
막내가 외갓집에 가기로 한날이 얼마나 남았지	막내 외갓집 갈 때까지 남은 기간	2
프로농구 삼 점슛 일 위 관련 기사는	프로농구 삼 점슛 일 위 관련 기사	2
목소리가 왜 그렇게 안 좋아	목소리 안 좋은 이유	2
목요일이 병원가는 날이니	목요일 병원가는 날인지	0
진료가 내일 오전 아홉 시로 예약 돼 있죠	진료 내일 오전 아홉 시인지	0
오늘 삼겹살 먹을까 스테이크 먹을까	오늘 삼겹살 스테이크 중 먹을 것	1
진짜야	진짜인지	0
올라가는 것이 언제니	올라가는 시간	2
종합주가지수가 높아지면 기업의 수익도 많아지는 거야	종합주가지수 높아지면 기업 수익 많아지는지	0
그날 말고	그날 아닌지	0
대통령의 취임한 날짜는 언제야	대통령 취임 날짜	2
여보 빨간 드레스 말인데 걸을까 접어 놓을까 	빨간 드레스 걸을지 접어놓을지	1
모레 지호엄마 몇 시에 어디서 만나기로 했지	모레 지호엄마 만나기로 한 시각 장소	2
용호동 천주교 묘지 앞 길 정체되나	용호동 천주교 묘지 앞 길 정체 상황	2
하나도 없어	하나도 없는지	0
주식시장에서 주식을 팔 경우 어떤 돈으로 지급하나요 	주식 팔 경우 지급 방법	2
이런 게 알레르기성 비염인가 요즘 코가 이상한 것 같아	알레르기성 비염인지	0
요즈음 어떻게 지내고 계셨는지 궁금합니다	근황	2
꽤 오랫동안 연락을 못한 것 같은데 별 일 없니 	근황	2
부산 해운대 해수욕장 개장일은 언제인데	부산 해운대 해수욕장 개장일	2
요즘 넌 뭐하고 지내	요즘 근황	2
부산 시내 지체구간 어딜까	부산 시내 지체구간 위치	2
끝나고 전화 할까	끝나고 전화할지	0
옛날부터 위장이 안 좋았어	옛날부터 위장이 안 좋은지	0
주식이 곧 유가증권을 말하는 거지	주식 유가증권 여부	0
심기가 왜 이리 뒤틀렸어 불만이 뭐야	불만	2
경부 고속도로에 정체 구간이 어딜까	경부 고속도로 정체 구간 위치	2
신체검사할 때 뭐뭐 하는데	신체검사 내용	2
너처럼 약속 잘지 키기로 유명한 사람이 갑자기 왜 그래 	갑자기 그러는 이유	2
요즘 경제면 최고 이슈는 뭐니	요즘 경제면 최고 이슈	2
오늘 저녁에 쇼핑 갈까 술 한 잔 할까 	오늘 저녁 쇼핑갈지 술한잔 할지	1
어젯밤 누구에게서 이메일이 왔지	어젯밤 이메일 보낸 사람	2
우리나라 야구선수 이승엽의 통산 성적 관련 기사는 없을까	이승엽 통산 성적 관련 기사	2
내일 습도는 어떻게 되지	내일 습도	2
스쿼시 하니까 어때 재밌나 나도 해볼까 	스쿼시 재밌는지	0
애인 조카녀석 학교 졸업식이 언제야	애인 조카녀석 학교 졸업식 날짜	2
내일은 비가 오니 안오니	내일 비 오는지	0
다리 다쳤어	다리 다쳤는지	0
주식회사는 자신의 주식을 취득할 수 있나요	주식회사 자신 주식 취득 가능 여부	0
망한 기업의 주식차트를 알 수 없을까요 	망한 기업 주식차트	2
내일 시험 보는 거 공부 끝났니 	내일 시험 공부 끝났는지	0
교통사고는 후유증이 더 심해	교통사고 후유증 더 심한지	0
오늘 박물관 열어요	오늘 박물관 여는지	0
양천구 목동 근처 양식 어디에 있니	양천구 목동 근처 양식 위치	2
수요일 첫 수업이 뭐지	수요일 첫 수업	2
뭐 먹을 거야	먹을 것	2
참 이번 주 일요일 날 우리 오빠가 술 산다고 하는데 올래	일요일 날 술 마시러 올지	0
오늘 시험 때문에 밤을 샜어 넌 공부 많이 했니 	공부 많이 했는지	0
우리 공장 가동율이 얼마나 되지	우리 공장 가동율	2
내가 갖고 있는 주식의 현재가치를 알고 싶습니다	내가 가진 주식 현재가치	2
홍대정문 가는 버스 없어	홍대정문 가는 버스 여부	0
잘 도착했다고 전화 왔어 	잘 도착했다고 전화 왔는지	0
서울에서 라식수술을 잘하는 안과는 어디래	서울에서 라식수술을 잘하는 안과	2
먹골엔 특산품 점이 많을까	먹골 특산품 점 많을지	0
케이블카도 교통 수단이라고 할 수 있을까 	케이블카 교통 수단 여부	0
제휴카드로 할인 받았어	제휴카드 할인 여부	0
이따 점심 먹고 영업 회의실에서 모인데	이따 점심 먹고 영업 회의실에서 모이는지	0
일반 근로자도 스톡옵션을 받을 수 있나 	일반 근로자 스톡옵션을 받을 수 있는지	0
지금 바람 풍속이 어떻게 되냐	지금 풍속	2
양재동 부근 교유문화회관 어떻게 가니	양재동 부근 교유문화회관 가는 방법	2
계획안 대로 진행해도 될까요 	계획안 진행 가능 여부	0
공익근무요원 생활은 잘하고 있어 	공익근무요원 생활 잘하는지	0
추가된 일정에 해당되는 사람 누구인가	추가 일정 해당되는 사람	2
오늘 만나서 뭐 할래	오늘 만나서 할 것	2
문학과 예술 중에서 추천할 만한 강좌 있어	문학 예술 중 추천할 만한 것	1
이 동네 갑자기 왜 이렇게 막히지 	막히는 이유	2
내일 해운대에 비가 올 확률은	내일 해운대 비 올 확률	2
지금 바빠	지금 바쁜지	0
신용카드 유효기간 지났어	신용카드 유효기간 지났는지	0
내일 비행기 예약 시간은 몇 시지	내일 비행기 예약 시간	2
형네 아기 출산일이 언제지	아기 출산일	2
버스카드 충전한다더니 왜 돈을 내고 왔어 	돈 내고 온 이유	2
체육시간에 줄넘기 시험 보는데 어쩌지	체육시간 줄넘기 시험 대책	2
할머니 언제 약 드셔야 하니	할머니 약 드실 시간	2
대한항공의 요금 얼마니	대한항공 요금	2
구정 연휴에도 출근해야 돼요	구정 연휴 출근해야 되는지	0
첨부 파일이 든 메일은 몇 통일까	첨부 파일 든 메일 수	2
사람이 몇 명인데 고기 뷔페로 가	사람 수	2
턱 수술 잘못되면 혀 짧아진데	턱 수술 잘못되면 혀 짧아지는지	0
요즘 씨엠에이 금리 몇 퍼센트래	요즘 씨엠에이 금리 퍼센트	2
구월 일일부터 구월 사일까지의 날씨를 보여줄까	구월 일일부터 구월 사일까지 날씨	2
강남구청 가려면 버스와 지하철 중 어느 쪽이 더 나은가요	강남구청 갈 때 버스 지하철 중 나은 것	1
서면 밀리오레 근처 유명한 닭 집 어떻게 간데	서면 밀리오레 근처 유명한 닭 집 가는 방법	2
그 은행에서 만들 수 없데	그 은행에서 만들 수 없는지	0
눈 때문에 버스 운행 못한데	눈 때문에 버스 운행 못하는지	0
현금 인출기가 고장이 났어 그 속에 내가 들었는데 어떻하지	현금 인출기 고장 대책	2
이번 학기는 몇 학점을 들어야 할까 	이번 학기 학점 수	2
신용카드 번호 외우고 있어	신용카드 번호 외우는지	0
제 짐은 어디서 찾나요	짐 찾는 곳	2
잠실에 찜질방이 어디어디 있지	잠실 찜질방 위치	2
형 요즘도 주유차 타세요 기름 값 많이 올랐죠 	요즘도 주유차 타는지	0
잘 있어	잘 있는지	0
결혼식 못 가니까 대신 축의금 부쳐 준다고 해 봐	축의금 부쳐 준다고 해 볼지	0
선거에서 공약과 사람 중 어떤 걸 봐	선거에서 공약 사람 중 보는 것	1
현재 전국 풍량은 어떨까	현재 전국 풍량	2
어젯밤 새 메일 중 알림 이메일을 찾니	어젯밤 새 메일 중 알림 이메일을 찾는지	0
민간요법이 정말 효과가 있을까 	민간요법 효과 여부	0
밤새서 하는 공부는 별로 효율이 없데	밤새 공부 효율 있는지	0
신촌이랑 홍대 중 어디가 편했어	신촌 홍대 중 편했던 곳	1
엘지가 금호랑 계약하는날이 언제지	엘지 금호 계약일	2
생일파티 몇 시 쯤 이야	생일파티 시각	2
생활 체육 관련 기사는 없을까	생활 체육 관련 기사 여부	0
서울에서 언제 출발이야	서울 출발 시각	2
삼백 일동에 농협 현금지급기가 있니	삼백 일동 농협 현금지급기 여부	0
저번 달 가족모임이 언제였지	저번 달 가족모임 날짜	2
밖에 지금 비 오는데 우산은 챙겨왔어 	우산 챙겨왔는지	0
날씨가 안 좋아서 비행기 이륙 못해	비행기 이륙 가능 여부	0
우리나라 지역별로 전운량은 얼마나 되나	우리나라 지역별 전운량	2
숙명여대 앞 과일 전문점은 어디에 있어	숙명여대 앞 과일 전문점 위치	2
동서대 주변에 파마 제일 잘하는 미용실은 어떻게 간데	동서대 주변 파마 잘하는 미용실 가는 방법	2
열한시 넘어야 끝날 거 같아	열한시 넘어야 끝나는지	0
별일은 없고	별일 없는지	0
한국어 정보처리학회 논문 심사 발표일이 언젠데	한국어 정보처리학회 논문 심사 발표일	2
어젯밤은 새 이메일이 한 통도 없었나	어젯밤 새 이메일 여부	0
네 과외 선생님은 실력이 어떠셔 	과외 선생님 실력	2
부산역 근처 삼성 에이에스센터가 어디니	부산역 근처 삼성 에이에스센터 위치	2
이대 주변 컷트를 제일 잘하는 미용실은 어떻게 간데	이대 주변 컷트 제일 잘하는 미용실 가는 방법	2
위염이라고 하는데 심한건 아니야	위염 심한건 아닌지	0
학교는 잘 다니고 있지	학교 잘 다니는지	0
강남역 주변 카레 전문점은	강남역 주변 카레 전문점	2
어떻게 하면 빠른 시일 내에 모두 배울 수 있지 	빠른 시일 내에 모두 배울 수 있는 방법	2
왜 아직까지도 돈을 안 붙여줄까	아직까지 돈 안 붙여주는 이유	2
머리가 너무 아픈데 무슨 병원을 가야 하는 거야 	머리 아픈데 갈 병원	2
제약 회사에서는 건강 챙겨주냐	제약 회사 건강 챙겨주는지	0
여윳돈으로 조금 투자해 봤어	여윳돈으로 투자해 봤는지	0
족욕 하니까 좋은 것 같아 	족욕 좋은지	0
요새 계속 더워지는 이유 알아	요새 계속 더워지는 이유	2
이번에 경품 당첨됐어	경품 당첨 여부	0
우리은행에서 뽑으면 수수료 적게 나와	우리은행에서 뽑으면 수수료 적게 나오는지	0
어젠 너무 과음했다 속은 좀 괜찮아 	속 괜찮은지	0
내일 입찰은 몇 시지	내일 입찰 시각	2
월 렌탈 비용은 얼마야	월 렌탈 비용	2
이 근처에 공중 화장실 있어요	근처 공중 화장실 위치	2
우리 둘이 자유여행 갈까 패키지가 나을까	둘이 자유여행 갈지 패키지가 나을지	1
여기서부터 링컨 센터까지는 몇 정거장인가요	여기서부터 링컨 센터까지 정거장 수	2
내일 스쿠버 다이빙 하는데 가볼까	내일 스쿠버 다이빙 가볼지	0
남산동 진입 구간 흐름은 어때	남산동 진입 구간 흐름	2
대출 받으려고 하는데 어느 은행이 제일 좋으니 	대출받기 좋은 은행	2
액면가와 주가의 차이를 모르겠어	액면가와 주가의 차이	2
체크카드로 인터넷 쇼핑 결제할 수 있어	체크카드로 인터넷 쇼핑 결제할 수 있는지	0
서강대 근처 농협 위치를 알려라	서강대 근처 농협 위치	2
시드니까지 할인 항공권 있나요	시드니 할인 항공권 여부	0
화장실은 어디에요	화장실 위치	2
청소년 축구대표팀의 근황은	청소년 축구대표팀 근황	2
그럼 넌 이제 뭐 하는 거야	이제 할 것	2
지민이와 도자기 축제에 가기로 한날이 언제야	지민이와 도자기 축제 가기로 한날	2
최초의 교통법규가 뭔지 아세요 	최초 교통법규	2
신용불량자 회복 제도는 알아봤니	신용불량자 회복 제도	2
우리 회사랑 계약하기로 했어	우리 회사랑 계약하기로 했는지	0
금요일에 나오긴 하는거야	금요일 나오는지	0
여자친구 생일이 양력으로 몇 월 며칠이야	여자친구 양력 생일	2
고속버스 탈까 기차 탈까	고속버스 기차 중 탈 것	1
김포공항 근처 롯데리아 어디지	김포공항 근처 롯데리아 위치	2
달맞이 고개에서 전망 제일 좋은 음식점은 어떻게 가니	달맞이 고개 전망 제일 좋은 음식점 가는 방법	2
학교 운동장에 전시했어	학교 운동장 전시 여부	0
윤하는 내가 보낸 메일 수신했니	윤하 메일 수신 여부	2
너 예전에 다니던 회사가 증권회사라고 하지 않았어	예전 다니던 회사 증권회사 여부	0
개구리 만드는 것 유치원에서 배웠니 	개구리 만드는 것 유치원에서 배웠는지	0
급행의 추가 요금은 얼마에요	급행 추가 요금	2
과외비를 못 받았는데 그런 건 어디다가 신고해 	과외비 못 받았을 때 신고할 곳	2
오늘 오후의 예상 강수량은 얼마야	오늘 오후 예상 강수량	2
컴퓨터로 가계부 쓰고 있어	컴퓨터로 가계부 쓰고 있는지	0
항공으로 얼마죠	항공 가격	2
해외펀드에 투자하는 사람들도 있어	해외펀드 투자하는 사람들 있는지	0
방폐장 주민투표 발표가 언제 되는 거야 	방폐장 주민투표 발표 날짜	2
컴퓨터 새로 사기로 했어	컴퓨터 새로 사기로 했는지	0
장외 등록 주식은 뭐야	장외 등록 주식 의미	2
코스닥에 등록된 기업이 몇 개쯤 되나요	코스닥 등록 기업 수	2
통도 환타지아가 있는 지역의 날씨는	통도 환타지아 지역 날씨	2
인라인 장비를 사러 왔는데 어그레시브용이래 이게 뭐야 	인라인 장비 어그레시브용 의미	2
캣츠 일곱시 반 표 예매했는데 괜찮으시죠	일곱시 반 표 괜찮은지	0
기차 타고 가는 것이 좋을까 아니면 버스 타고 가는 것이 좋을까	기차 버스 중 타고 갈 것	1
이번 주 수요일까지 보고서 완성해서 제출하게	이번 주 수요일까지 보고서 제출할지	0
잘 살아	잘 사는지	0
사랑하는 친구야 보고 싶다 언제 볼까 	만날 시기	2
다리 다쳤어	다리 다쳤는지	0
제일은행도 예금금리를 올렸어	제일은행 예금금리 올렸는지	0
너는 영어와 수학 둘 중 어느 과목이 좋니	영어 수학 중 좋은 것	1
추가납부기간은 언제지	추가납부기간	2
내가 주식을 매각 할수 없는 이유가 뭐냐	내가 주식을 매각 못하는 이유	2
그 헬스클럽 괜찮아	그 헬스클럽 괜찮은지	0
이봉주 선수의 아테네 경기 관련 기사는 없을까	이봉주 선수 아테네 경기 관련 기사	2
아이 계속 안생기면 입양할거야	아이 계속 안생기면 입양할지	0
서울대학병원 근처 편의점은 어떻게 가	서울대학병원 근처 편의점 가는 방법	2
오늘의 습도 얼마지	오늘 습도	2
오늘 정오의 기온이 얼마 될까	오늘 정오 기온	2
태권도 관련 기사는 없을까	태권도 관련 기사 여부	0
해외 펀드 어디로 들었으면 좋겠어 	들만한 해외 펀드	2
전공수업인데 수강정원이 왜 그렇게 작아	수강정원 작은 이유	2
샴페인 터뜨리기는 아직 일러	샴페인 터뜨리기 이른지	0
증권거래소랑 코스닥 중에 어느 곳이 좋을까	증권거래소 코스닥 중 좋은 곳	1
점심은 뭐 먹었어 매일 똑같은 거 먹기 지겹지 	점심 먹은 것	2
지금 강남대로 막히나	지금 강남대로 막히는지	0
네가 투자한 주식이 과연 오를까 	투자 주식 오를지	0
우리은행에서 뽑으면 수수료 적게 나와	우리은행에서 뽑으면 수수료 적게 나오는지	0
나 여섯 시 공연으로 예매 했는데 괜찮지 	여섯시 공연 괜찮은지	0
교수님이랑 오늘 저녁 약속이 있어	교수님이랑 오늘 저녁 약속 있는지	0
니 생일은 언제니	생일 날짜	2
선물과 연계해서 생각해	선물 연계해서 생각할지	0
대출 상품이 많기는 한거 같은데 나한테 맞는 게 뭐가 있을까	나한테 맞는 대출 상품	2
오 킬로미터는 뛸 수 있어	오 킬로미터 뛸 수 있는지	0
다음 주 화요일에 우리 보기로 한 거 맞지	다음 주 화요일에 보기로 한 거 맞는지	0
입실 언제니	입실 시간	2
오늘 거래소가 몇 포인트로 마감했죠	오늘 거래소 마감 포인트	2
내일 흐리데	내일 흐린지	0
환율도 주가에 영향을 미쳐	환율 주가 영향 여부	0
일 주일 패스 얼마냐	일 주일 패스 수	2
니스의 카니발 여행 예약할래	니스 카니발 여행 예약할지	0
바람도 선선해지고 낙엽도 지고 왠지 쓸쓸한데 넌 어때  	쓸쓸한지	0
해외 투자에 따르는 추가적 위험은 뭐라고 생각해 	해외 투자 추가적 위험	2
엄마가 용돈 안주신데	엄마가 용돈 안주시는지	0
타행으로 계좌이체하면 돈이 더 드는데 다른 계좌는 없어 	다른 계좌 여부	0
오늘 뉴스 속보는 뭘까	오늘 뉴스 속보	2
어젯밤 온 메일 중 첨부 파일이 든 메일은 얼마나 된데	어젯밤 온 메일 중 첨부 파일 든 메일 수	2
제주도 이박 삼일 다녀오는 걸로 예약했는데 괜찮지 	제주도 이박 삼일 괜찮은지	0
주식의 양도는 어떻게 이루어 지는 거야	주식 양도 방법	2
너 지금 어디야 십분 후면 도착해	지금 위치	2
왜 자꾸 내 계획안은 퇴짜맞는 걸까	내 계획안이 자꾸 퇴짜맞는 이유	2
강남구청 가려면 버스와 지하철 중 어느 쪽이 더 나은가요	강남구청 가려면 버스 지하철 중 나은 것	1
굴다리 앞에서 신호가 짧아요	굴다리 앞에서 신호가 짧은지	0
독일 맥주축제 언제니	독일 맥주축제 시기	2
어제 농구 삼성과 티지 삼보의 경기 관련 기사 어떤 내용이지	삼성 티지 삼보 경기 관련 기사 내용	2
카드 잃어버렸는데 어디에 신고 해야 돼요	카드 분실 신고할 곳	2
이월 삼일이 맞선 보는날이야	이월 삼일 맞선 보는날인지	0
노량진 주변 일식집은 어디에 있는가	노량진 주변 일식집 위치	2
영화 보고 있음	영화 보고 있는지	0
보증서도 같이 있어요	보증서 여부	0
주식 위험도를 어떻게 비교할 수 있을까 	주식 위험도 비교 방법	2
거기서 시외버스 타고 오면 편해	시외버스 타고 오면 편한지	0
공부다 제일 쉬웠다던데 정말이야 	공부가 제일 쉬웠는지	0
천천히 가	천천히 갈지	0
여행자 수표를 가져갈까 통장을 만들까 고민 중이야	여행자수표를 가져갈지 통장을 만들지	1
다들 점심약속 있으시죠	점심약속 있는지	0
파란 우산 줄까 빨간 우산 줄까	파란 우산 빨간 우산 중 줄 것	1
비행기를 예약하려고 하는데 인터넷 예매가 가능한가요 	비행기 예약 인터넷 예매 가능 여부	0
너는 왜 필기 안 하는데	필기 안 하는 이유	2
사업계획을 짜보셨나요 	사업계획 경험 여부	0
이번 주에도 계속 비가 오나요 	이번 주 계속 비 오는지	0
통장을 만들려면 뭐가 필요한지 아니 	통장 만들려면 필요한 것	2
그 곳은 왜 버스로는 갈 수 없는 걸까 	그 곳 버스 갈 수 없는 이유	2
내일 부산의 구름의 양은 얼마나 돼	내일 부산 구름 양	2
사회탐구 영역이 문제야	사회탐구 영역이 문제인지	0
이제는 주로 뭐하고 지내 	주로 하고 지내는 것	2
우리나라에도 미국의 다우 존스 지수 같은 게 생긴데	우리나라에도 미국의 다우 존스 지수 같은 게 생기는지	0
캐쉬 로비는 몇 시까지지	캐쉬 로비 기한	2
너무 전화가 자주와	너무 전화가 자주오는지	0
큰 아들 방학 시작일이 얼마나 남았지	큰 아들 방학 시작일까지 기간	2
얼마나 바꿔드릴까요	바꿔줄 양	2
고객 유치를 위한 세미나가 어떨까요	고객 유치 위한 세미나 어떨지	0
둘째 담임 선생님 방문일이 언제야	둘째 담임 선생님 방문일	2
혹시 내일 우박이 내린다는 예보가 있어	내일 우박 예보 있는지	2
거래처 부장하고 몇 시에 만나기로 되어있냐	거래처 부장 만나는 시각	2
유정이가 파일을 첨부해 편지보냈니	유정 파일 첨부 여부	2
전주 특산품이 뭐니	전주 특산품	2
압구정동에서 쌍꺼풀 수술 잘하는 성형외과는 어떻게 가니	압구정동 쌍꺼풀 수술 잘하는 성형외과 가는 방법	2
그거 예금통장으로 넣으면 되	그거 예금통장으로 넣으면 되는지	0
지금 공장 가동률이 몇 퍼센트나 되지	지금 공장 가동률	2
성함과 방 번호가 어떻게 되시나요	성함 방 번호	2
올해 취업했지 취직준비는 잘 돼가니 	취직준비 잘 돼가는지	0
고려대 앞에서 제일 유명한 떡복기집은 어디야	고려대 앞 제일 유명한 떡복기집	2
한 번씩 모이려고 하며 왜 이리 다들 바쁜 것이냐	다들 바쁜 이유	2
너 회계원리 족보 가지고 있어 	회계원리 족보 여부	0
예금 금리가 왜 이렇게 낮을까 	예금 금리 낮은 이유	2
뉴욕까지의 왕복이 비싸요	뉴욕 왕복 비싼지	0
아이티쪽은 평균치라는 게 없어	아이티쪽 평균치 여부	0
어젯밤 안 읽은 이메일이 있냐	어젯밤 안 읽은 이메일이 있는지	0
당뇨병은 많이 좋아 지셨나요	당뇨병 좋아졌는지	0
아버지 병원은 잘 다녀 왔어 괜찮으셔	아버지 괜찮으신지	0
가짜 수표는 보상 받을 수 없나요 	가짜 수표 보상 방법	2
허리 다쳤어	허리 다쳤는지	0
벌써 말복이래요 점심 때 삼계탕 좋으시죠 	점심 삼계탕 좋은지	0
엘지정유 주식의 액면가가 얼마인가요	엘지정유 주식 액면가	2
주택 부금 만료일이 언제야	주택 부금 만료일	2
서울대 근처 피자헛은 어디일까	서울대 근처 피자헛 위치	2
청담동에서 가장 유명한 네일숍 어디냐	청담동 유명한 네일숍	2
영화 볼까 아니면 연극을 볼까	영화 연극 중 볼 것	1
쇼핑몰 근처에 병원들 많아	쇼핑몰 근처에 병원들 많은지	0
그 여자 만나고 싶어	그 여자 만나고 싶은지	0
차 고장 났어	차 고장 났는지	0
아직 예약 안했어	아직 예약 안했는지	0
내일의 불쾌지수는 얼마나 될까	내일 불쾌지수	2
바나나 보트와 땅콩 보트 중 어느 것을 탈래	바나나보트 땅콩보트 중 탈 것	1
어제 교회엔 잘 다녀왔나	교회 잘 다녀왔는지	0
저녁에 과외선생님 오셔	저녁 과외선생님 오시는지	0
별도의 계좌 유지 수수료가 있나요 	별도 계좌 유지 수수료 여부	0
한의원 가서 침 맞으면 아프지 않아 	한의원 침 아픈지	0
우리 같이 중국 다녀 온 게 몇 년 전이지	같이 중국 다녀온 시기	2
어제 학교에서 보니까 많이 아파보이던데 오늘은 어때 	오늘 괜찮은지	0
저번겨울에 뵌 뒤로 못 봤는데 건강하시죠	건강한지	0
홈쇼핑에서 보험을 계약하면 더 나을까	홈쇼핑 보험 계약 더 나을지	0
일반석은 얼마니	일반석 가격	2
당신의 안부가 정말로 궁금합니다	안부	2
바쁘니	바쁜지	0
생계형 적금은 어떻게 가입하는 거야 	생계형 적금 가입 방법	2
나라마다 교통 법규는 모두 다르지	나라마다 교통 법규 모두 다른지	0
신제품의 주요 고객 연령층은 어떻게 예상하고 있는가	신제품 주요 고객 예상 연령층	2
심야 영업도 되는 건가 	심야 영업 가능 여부	0
부산대앞 쥬얼리는 어디에 있어	부산대앞 쥬얼리 위치	2
겨울방학 토플강좌 일정이 어떻게되	겨울방학 토플강좌 일정	2
요즘은 한참 천원샵 그런 게 많던데 그런 쪽은 어때 	천원샵 어떤지	0
장외주식 거래 시 양도세 산출기준이 어떻게 되는가 	장외주식 거래 시 양도세 산출기준	2
오늘 온 편지 중 첨부 파일 든 편지 얼마나 되는가	오늘 온 편지 중 첨부 파일 든 편지 양	2
오늘 누구 왔었어	오늘 온 사람	2
미 상공회의소 회장과 인터뷰 기사는 뭐래	미 상공회의소 회장과 인터뷰 기사	2
길동 근처의 길동사거리 정체되는지 알 수 있을까	길동 근처 길동사거리 정체 여부	0
세계 주요 도시의 강수 분포도는 어떠니	세계 주요 도시 강수 분포도	2
주택청약부금 넣으면 집구하기가 쉬워져	주택청약부금 넣으면 집구하기가 쉬운지	0
증빙 서류는 어디에 놨어	증빙 서류 놓은 곳	2
무용하면 몸이 좀 유연해질까 	무용하면 몸 유연해질지	0
오늘 메일 중 첨부 파일 든 메일 있데	오늘 메일 중 첨부 파일 든 메일 여부	0
휴업손해도 보상받았어	휴업손해 보상 여부	0
일본 경유하는 것으로 예약할래	일본 경유하는 것으로 예약할지	0
토익은 혼자 공부하는 게 좋을까 학원을 다니는 게 좋을까	토익 혼자 공부할지 학원 다닐지	1
나 오늘부터 방학이 시작했는데 너희학교는 방학했니 	방학했는지	0
수신자 이름이 김진인 메일이 몇 통이지	수신자 이름 김진 메일 수	2
이번 월드컵 예선전이 언제까지 열리지	이번 월드컵 예선전 개최 기간	2
예비 소집일 가야 하는 거야	예비 소집일 가야 하는지	0
상가 쪽으로 나왔는데 버스 정류장 어디 있어	상가 쪽 버스 정류장 위치	2
첨부 파일 든 이메일이 없는가	첨부 파일 든 이메일 여부	0
압구정에 성형외과가 안면윤곽전문이래	압구정 성형외과 안면윤곽전문인지	0
청담동에서 가장 유명한 미용실은 어디야	청담동 가장 유명한 미용실	2
오늘부터 백화점 세일이야	오늘부터 백화점 세일인지	0
그 기업의 재무구조는 괜찮은 편이지	그 기업 재무구조 괜찮은 편인지	0
너 주식한다면서 여윳돈은 좀 있는 거야 	여윳돈 있는지	0
경유 항공편 예약해	경유 항공편 예약할지	0
우리 부모님 뵙기로 약속한 거 아직 유효해 	우리 부모님 뵙기로 한 약속 유효한지	0
아침식사를 안 하면 요금이 얼마니	아침식사 없는 요금	2
첨부 파일이 든 메일 없냐	첨부파일 든 메일 있는지	0
올해 어머니 생신은 무슨 요일이지	올해 어머니 생신 요일	2
예매는 전화로는 불가능 해	예매 전화 가능 여부	0
여유자금이 생길 때마다 자유롭게 저축하는 상품은 없나요 	여유자금 자유 저축 상품	2
오늘 오후에 비가 내릴 확률은	오늘 오후에 비가 내릴 확률	2
그 회사는 투자유의종목이야	그 회사는 투자유의종목인지	0
영화를 볼까 연극을 볼까	영화 연극 중 볼 것	1
지난 번 일은 잘 해결됐어	지난 번 일 잘 해결됐는지	0
현재 중부 상행선에서 교통이 통제되는 구간은 어떠냐	현재 중부 상행선 교통 통제 구간 상태	2
서울대 근처 당구장은 어떻게 가냐	서울대 근처 당구장 가는 방법	2
석이 돌 잔치가 언제지	석이 돌 잔치 날짜	2
경부 고속도로 내 소통 원활한 구간은 어떨까	경부 고속도로 내 소통 원활 구간	2
신용카드 번호 외우고 있어	신용카드 번호 외우는지	0
이번 학기에 몇 학점 듣니	이번 학기 듣는 학점	2
눈에 멍이 들면 왜 계란으로 비비는 걸까 	눈 멍 들면 계란 비비는 이유	2
그 남자 만나도 돼	그 남자 만나도 되는지	0
다음달에 해외 파견근무 나가	다음달 해외 파견근무 나가는지	0
서울시에서 하는 간선 버스와 지선 버스는 무엇입니까 	서울시 간선 버스 지선 버스	2
일본은 지금 몇 시에요	지금 일본 시각	2
오늘 생활한자 뭐지	오늘 생활한자	2
주식이 과연 운일까 실력일까	주식이 운일지 실력일지	1
사회 시험범위는 삼과까지래	사회 시험범위는 삼과까지인지	0
오늘 아침 남자친구한테서 온 메일 있어	오늘 아침 남자친구한테 온 메일	2
홍대 부근 아이스크림 전문점은 어디지	홍대 부근 아이스크림 전문점	2
부장님 이번 주 금요일에 월차 써도 될까요	이번 주 금요일 월차 가능 여부	0
간접 투자할 방법은 없을까 	간접 투자 방법	2
폭풍경보가 내려진 지방은 어디지	폭풍경보 지방	2
올해 한국어 정보처리 학회는 언제 시작하지	올해 한국어 정보처리 학회 시작 일시	2
작년에도 이맘때쯤 눈이 왔었어	작년 이맘때 눈 왔었는지	0
어린이 운임 얼마니	어린이 운임	2
수학 단과반은 수강료가 얼마쯤 하니	수학 단과반 수강료	2
내일 비 온데	내일 비 오는지	0
진짜지	진짜인지	0
너 혹시 교육학 인터넷 강의 들어본 적 있어	교육학 인터넷 강의 경험 여부	0
병목 정체를 보이는 구간은 어디지	병목 정체를 보이는 구간	2
오늘 까쓰수리공이 온다고 한 시간이 언제일까	까쓰수리공 오는 시간	2
리포트 제출일이 다음주 화요일까지야	리포트 제출일 다음주 화요일까진지	0
보충학습이 왜 생겨난 것입니까 	보충학습 생겨난 이유	2
조심스레 잘 지내셨냐는 안부 여쭙니다	잘 지내는지	0
어떻게 공부한 거야 너도 공부가 제일 쉬웠어요 이거야 	공부 방법	2
뭐라고 부르면 좋을까요	호칭	2
영임이가 오기로 한 날은 언제지	영임이 오기로 한 날	2
부산 국제 영화제는 언제 시작하지	부산 국제 영화제 시작 시각	2
일반석은 얼마니	일반석 가격	2
소호는 이쪽인가요	소호 이쪽인지	0
윤리학 점수 나온 거 봤니	윤리학 점수 봤는지	0
너 나한테 탁구 배워보지 않을래 	탁구 배울지	0
경영학개론 진짜 어려웠어	경영학개론 어려운지	0
그 종목의 숨겨진 리스크가 있지 않을까	그 종목 숨겨진 리스크	2
오늘 달러 환율 얼마예요	오늘 달러 환율	2
기억은 되돌아 온거야 괜찮니	기억 되돌아 왔는지	0
영업 시간 외 출금하면 수수료 붙어	영업 시간 외 출금 수수료 여부	0
직행 버스 타는 게 빨라요	직행 버스 빠른지	0
아픈 데는 없이 잘 크고 있죠	아픈 데 없이 잘 크고 있는지	0
한의원에서 지어온 약이 잘 들어	한의원 약 잘 드는지	0
대출 자격 요건이 있나요	대출 자격 요건 여부	0
실질 이자 효과가 어떻게 되는데 	실질 이자 효과	2
살이 빠졌는데 어디 아픈데 있는 건 아니지 	아픈 데 있는지	0
게임방 갈까	게임방 갈지	0
장난 아냐	장난 아닌지	0
단양 인터체인지에서 경주 인터체인지까지 가스충전소가 있는 휴게소는 몇 군데지	단양 인터체인지에서 경주 인터체인지까지 가스충전소가 있는 휴게소 수	2
현재 경부 고속도로의 소통은 원활하니	현재 경부 고속도로 소통 상황	2
무슨 뜻이야	의미	2
초복까지 얼마나 많이 남았지	초복까지 남은 기간	2
나한테 불만 있어요 요즘 왜 그래요 	불만 있는지	0
내일 프랑스의 날씨는 어떻지	내일 프랑스의 날씨	2
항상 보고 싶어 	항상 보고 싶은지	0
대학원 시험 접수 날짜는 언제니	대학원 시험 접수 날짜	2
우리 발표회가 한 달 뒤야	우리 발표회 한 달 뒤인지	0
결재 서류 벌써 올렸어요 	결재 서류 벌써 올렸는지	0
몇 번 했어요	한 횟수	2
주변에 주식 하는 사람 없어 뭐 물어볼게 있는데	주변 주식 하는 사람 여부	0
살이 빠졌는데 어디 아픈데 있는 건 아니지 	아픈 곳 있는지	0
듣기 싫어	듣기 싫은지	0
거실불 꺼	거실불 끌지	0
교수님 이번 시험 관련 범위 알려주신대	교수님 이번 시험 관련 범위 알려주시는지	0
근처에 캐쉬백적립되는 주유소가 있어	근처 캐쉬백적립 가능 주유소	2
회신 메일은 모두 몇 통이냐	회신 메일 수	2
엘지필립스가 왜 뜨는데	엘지필립스 뜨는 이유	2
학원에도 자율학습이 있다는데 꼭 해야 하는 거니 	학원 자율학습 꼭 해야 하는지	0
이번 품평회까지 샘플 다 나와야 하는데 가능합니까 	품평회까지 샘플 가능 여부	0
구정 연휴에도 출근해야돼	구정 연휴 출근 여부	0
요즘 대학생들은 취직 때문에 공부 열심히 해	요즘 대학생들 취직 때문에 공부 열심히 하는지	0
휴일에는 교통카드 충전하는 데 없어	휴일 교통카드 충전 가능한 곳	2
스승님 건강은 좀 어떠세요	스승님 건강	2
오늘의 종목별 경기결과는	오늘 종목별 경기결과	2
왜 그래	이유	2
이번 장마로 인한 피해액은	이번 장마 피해액	2
날씨가 조금만 추워도 손과 귀가 가려워 동상 걸린 걸까 	동상 여부	0
저번 주에 비가 내리는 날은 언제였지	저번 주 비 내리는 날	2
오늘 주가는 어떠니	오늘 주가	2
동네에 은행이 하나도 없어	동네 은행 없는지	0
거기 가기 싫어요	거기 가기 싫은지	0
요즘 어떻게 지내니 우리 못 본 지 꽤 된 것 같아	요즘 근황	2
걸어서 얼마나 멀어요	걸어서 거리	2
외국에서 뜨는 사업이 뭐가 있을까 	외국에서 뜨는 사업	2
서울까지 운임 비싸니	서울까지 운임 비싼지	0
어떻게 하면 투자자들을 많이 유치할 수 있을까요 	투자자 유치 방법	2
선생님이 교무실로 오라고 하시던데 뭐 잘못했어	잘못 여부	0
외국인 매도공세의 주요 이유는 뭐야 	외국인 매도공세 주요 이유	2
양구 경유해서 가	양구 경유해서 가는지	0
보스턴까지 왕복표는 얼마에요	보스턴 왕복표 가격	2
건강 검진은 몇 개월에 한 번씩 받으세요	건강 검진 주기	2
너 의료 봉사 신청했어 	의료 봉사 신청 여부	0
약속 시간이 언제	약속 시간	2
후유증은 없니 괜찮아 빨리 나아야 할 텐데	후유증 여부	0
다음주 주말에는 쉴 거야	다음주 주말 쉴지	0
귀 아픈건 괜찮니 병원에서 머래	귀 괜찮은지	0
약은 먹었어	약 먹었는지	0
다음달 공채에 지원해보려고	다음달 공채 지원 여부	0
과장님께 이거 여쭤 봐도 될까	과장님께 여쭤 봐도 될지	0
우리 토요일에 볼까 일요일에 볼까	토요일에 볼지 일요일에 볼지	1
유산소 운동을 하면 중풍예방에 도움이 돼	유산소 운동 중풍예방 도움 되는지	0
지윤이 생일이 이번 주인가	지윤이 생일 이번 주인지	0
선물 옵션이 궁금 하네	선물 옵션 의미	2
별일 아냐	별일 아닌지	0
풀햄에 대한 기사는 없을까	풀햄 기사	2
오늘의 주요 기사는 뭐니	오늘 주요 기사	2
첫 월급 타면 부모님께 뭘 사드릴까 	첫 월급 타면 부모님께 사드릴것	2
이 일을 하기 전에는 어떤 자격이 필요한 걸까	일 하기 전 필요 자격	2
내가 인터넷에서 물건을 산 날은	내가 인터넷에서 물건 산 날	2
가락시장 근처 전통 음식점 어디지	가락시장 근처 전통 음식점 위치	2
불 다 꺼	불 다 끌지	0
지금 조금 바뻐	지금 바쁜지	0
해운대 근처 당구장 어디일까	해운대 근처 당구장 위치	2
내일 서울에 비가 내릴 확률은 얼마나 되지	내일 서울 비 내릴 확률	2
오늘 전남지역 지역 구름 양은 어떻데니	오늘 전남지역 구름 양	2
인터넷으로 예금을 가입하면 좋은 점이 뭐야 	인터넷 예금 가입 장점	2
조금 뒤에 있을 세미나 올 거지	조금 뒤 세미나 올지	0
근데 진짜 운동하면 살이 빠지긴 빠지는 거야	운동하면 살 빠지는지	0
네 카드 되지	카드 되는지	0
돈이 좀 생겼는데 저축하는 게 나을까 주식에 투자하는 게 나을까	저축 주식투자 중 나은 것	1
내일 스승의 날인데 교문에서 만나는 거야	내일 교문에서 만나는지	0
어떻게 분산 투자를 해야 위험을 줄일 수 있는데	분산 투자 위험 줄이는 방법	2
그거 예금통장으로 넣으면 되	그거 예금통장으로 넣으면 되는지	0
서울 몇 시에 도착이니	서울 도착 시각	2
유아학습 및 놀이 사이트 어느 곳이 좋은가요 	좋은 유아학습 및 놀이 사이트	2
올해 할아버지 제삿날은 양력 몇 월 며칠이지	올해 할아버지 양력 제삿날	2
부산 시내 지체구간은	부산 시내 지체구간	2
직불 카드는 어떻게 사용하는 거야 	직불 카드 사용 방법	2
날씨가 더워져서 입맛도 없는데 살은 왜 자꾸 찔까 	살 자꾸 찌는 이유	2
새 편지 중 주문 확인 메일 있는지 확인해	새 편지 중 주문 확인 메일 있는지	0
계약 준비는 완벽하겠지	계약 준비 완벽한지	0
일주일에 몇 번 쉴 수 있는데	일주일 쉴 수 있는 횟수	2
생일파티를 할 장소가 어디지	생일파티 장소	2
현재 경부 고속도로의 날씨는 어떻데니	현재 경부 고속도로 날씨	2
그저 그래	그저 그런지	0
중북 고속도로 교통량이 어떠니	충북 고속도로 교통량	2
너 어릴 때 태권도 배웠지	어릴 때 태권도 배웠는지	0
아버지께서 당뇨병이 있으셔	아버지 당뇨병 있으신지	0
도산공원 부근 미장원 어디래	도산공원 부근 미장원 위치	2
시험공부 어떻게 해야 성적이 올라갈까 	성적 올라가는 시험공부 방법	2
범석 오빠랑은 아직도 사귀고 있어요	범석 오빠랑 아직 사귀는지	0
회사도 그만 뒀다면서 신용카드는 왜 만들어 	신용카드 만드는 이유	2
내일 광안리의 해수 온도는 어떻지	내일 광안리 해수 온도	2
정말 사랑하니	정말 사랑하는지	0
다음 주 오대산의 날씨는 어때	다음 주 오대산 날씨	2
주차하다가 옆 차를 긁었어 어쩌지	옆 차 긁을 때 대책	2
필드에 한 번 나가면 캐디 비가 얼마쯤 들까	필드 한 번 캐디 비	2
우리 시험범위가 어디서부터 어디까지지 	시험범위	2
김정일 가족관계 모름	김정일 가족관계	2
방학 동안 아르바이트 하게 됐어	방학 동안 아르바이트 하는지	0
우리 그럼 몇 년 뒤에 만나는 거야	몇 년 후에 만나는지	2
부동산 정책은 시간이 지나면 바뀔까 	부동산 정책 시간 지나면 바뀔지	0
건강보험에 친정 부모님을 비부양자로 등록할 수 없나요 	건강보험 친정 부모님 비부양자 등록 가능 여부	0
오늘 남해 고속도로 막히나	오늘 남해 고속도로 막히는지	0
기말고사 시험범위 알어	기말고사 시험범위	2
어제 전화 꺼 놨어 너 연락했었어	어제 연락 여부	0
이번에 전교 등수가 많이 떨어졌대	이번에 전교 등수 많이 떨어졌는지	0
현재 중부 상행선에서 교통이 통제되는 구간은 어디니	현재 중부 상행선 교통 통제 구간	2
어떤 방이 마음에 드세요	마음에 드는 방	2
매년 대학생 국토순례하는거 아직도 해	매년 대학생 국토순례 아직 하는지	0
저 같은 경우는 어떻게 주식투자를 준비해야 합니까	주식투자 준비 방법	2
동서대 근처 내과 어딘데	동서대 근처 내과	2
화물은 어디서 체크인하나요	화물 체크인 위치	2
예약 번호가 뭐지	예약 번호	2
운전면허시험에 또 떨어졌어	운전면허시험 또 떨어졌는지	0
뒤쪽으로 자리를 좀 옮겨도 될까요	뒤쪽으로 자리를 옮겨도 될지	0
너 어느 학교원서 낼 거야 	원서 낼 학교	2
인터넷 통장을 쓰면 송금 수수료가 없어	인터넷 통장 송금 수수료 여부	0
이번에 학교에서 하는 스노보드 강좌 들었니	학교 스노보드 강좌 들었는지	0
매출액 증가와 순이익 증가액은 비례할까	매출액 증가 순이익 증가액 비례 여부	0
모델 데뷔했다면서 언제 텔레비전에 나와 	텔레비전 나오는 시기	2
나도 포켓볼을 배워보고 싶은데 가르쳐 줄 거야 	포켓볼 가르쳐줄지	0
주식의 최소 거래 단위가 어떻게 되지	주식의 최소 거래 단위	2
서울까지 요금은 얼마야	서울까지 요금	2
오늘의 미팅 주제가 뭐지	오늘 미팅 주제	2
교수님 건강 하시죠	교수님 건강 여부	0
우리 타임캡슐 묻어놓은 거 생각나 	타임캡슐 생각나는지	0
모의주식은 실제랑 많이 다를까	모의주식 실제랑 많이 다를지	0
주가가 꽤 높은데 적립식 펀드 같은 곳에 가입해도 될까	적립식 펀드 같은 곳 가입해도 될지	0
왜 안 와 벌써 삼십분 기다렸어	안 오는 이유	2
척추가 휘어서 허리가 너무 아픈데 요가 할까	요가 할지	0
너 전공 공부 말고 따로 공부하는 거 있니 	전공 공부 말고 따로 공부하는 거 있는지	0
수요일에 동창회 한번 할까 	수요일 동창회 할지	0
구서동 파출소는 어디니	구서동 파출소 위치	2
같은 냉장고라도 홈쇼핑이 더 싸	같은 냉장고 홈쇼핑이 더 싼지	0
환전 정보가 잘 나와 있는 사이트 알고 있니 	환전 정보 잘 나와 있는 사이트	2
내년 대통령 선거일이 언제니	내년 대통령 선거일	2
용산 주변 전자 대리점은 어디에 있는가	용산 주변 전자 대리점 위치	2
학교에서 온 메일 있니	학교에서 온 메일 있는지	0
회의만 끝나면 금방 갈 거야	회의 끝나면 금방 갈지	0
내가 예상한 문제에서 한 문제도 안 나왔어	예상한 문제에서 한 문제도 안 나왔는지	0
내일 해가 뜨는 시각이 언제니	내일 해 뜨는 시각	2
창쪽 좌석으로 예약할래	창쪽 좌석 예약할지	0
아이큐랑 공부하는 거랑 상관있나 	아이큐 공부 상관 여부	0
추운데 왜 옷을 얇게 입고 다녀	추운데 옷 얇게 입는 이유	2
이번엔 어떤 영화 볼까 난 액션 싫어	액션 제외 볼 영화	2
주식을 인터넷으로 하는 게 좋을까 증권회사에서 하는 게 좋을까	주식을 인터넷으로 할지 증권회사에서 할지	1
오늘 만나서 뭐 할까 밥 먹고 영화나 볼까 	만나서 할 것	2
이번 주 일요일이 곗날 맞지	이번 주 일요일 곗날 맞는지	0
코스닥은 위험부담 크겠죠	코스닥 위험부담 큰지	0
부모님께서 주말에 계모임이 있으시데	부모님 주말 계모임이 있으신지	0
네 안부 묻는 애들이 많던데 왜 안 나왔어	안 나온 이유	2
잊어 버렸어	잊어 버렸는지	0
버스 요금은 얼만지 아냐	버스 요금	2
외국에서 내 계좌로 돈을 받을 때 아무 은행에서 받아도 돼	외국에서 내 계좌로 돈 받을 때 아무 은행에서 받아도 되는지	0
다음 차례에 써도 되나요	다음 차례 써도 되는지	0
당신의 안부가 정말로 궁금합니다	안부	2
너 전공 공부 말고 따로 공부하는 거 있니 	전공 말고 따로 공부 하는지	0
재성이 방에 뭐가 있지	재성이 방에 있는 것	2
시험 날짜 확실한거야 큰일이다	시험 날짜 확실 여부	0
시험 잘 봤니	시험 잘 봤는지	0
같은 학교인데 왜 이렇게 보기 힘드니 	보기 힘든 이유	2
지금 경인 고속도로는 원활하니	경인 고속도로 원활한지	0
오늘 일곱시에 약속있어	오늘 일곱시 약속 여부	0
박찬호 선수의 이적에 관련한 기사는	박찬호 선수 이적 관련 기사	2
닫을까 열어둘까 	닫을지 열어둘지	1
경리과에 출장비 지급요청해	경리과에 출장비 지급요청하는지	0
태풍의 눈은 고기압일까 저기압일까	태풍의 눈 고기압인지 저기압인지	1
수리 업무는 어느 업체에 맡겨야 할까	수리 맡길 업체	2
비행기 타면 더 빨리 올 수 있어	비행기 타면 더 빨리 올 수 있는지	0
불안한 증시에 주목할 만한 저베타주는 뭐가 있어	불안한 증시에 주목할 저베타주	2
정형외과에서 이상무래	정형외과 이상 여부	0
친구들과 계모임 하는 날이 언제야	친구들과 계모임 날짜	2
조승우가 헤드윅을 맡는대 	조승우 헤드윅 맡는지	0
이상해	이상한지	0
걔는 요새 어떻게 지낸다니 	걔 근황	2
언제가 시간이 제일 편하세요	제일 편한 시간	2
여기서부터 링컨 센터까지는 몇 정거장인가요	여기서부터 링컨 센터까지 정거장 수	2
가짜 수표는 보상 받을 수 없나요 	가짜 수표 보상 여부	0
오늘 체감온도는 어떻데니	오늘 체감온도	2
우리회사 이번 공모전에 당선 됐어	우리회사 이번 공모전 당선 여부	0
내가 아침 운동을 하는 날짜는 언제인지	내 아침 운동 날짜	2
수위 아저씨께 가서 서류 작성하면 돼	수위 아저씨께 가서 서류 작성하면 되는지	0
인천 공항 근처 롯데리아는 어떻게 가니	인천 공항 근처 롯데리아 가는 방법	2
어제 보낸 메일 중 수신 확인 안 된 메일은 몇 통일까	어제 보낸 메일 중 수신 확인 안 된 메일 수	2
제주도에서 다금바리 회 파는 곳은	제주도 다금바리 회 파는 곳	2
영어 인터뷰 연습할 상대를 구하는데 적당한 사람 있을까 	영어 인터뷰 연습 적당한 상대	2
맨 앞에서 탈까 맨 뒤에서 탈까 	맨앞에서 탈지 맨 뒤에서 탈지	1
적금이 좋을까 저금이 좋을까	적금 저금 중 좋은 것	1
갑자기 가족회의라뇨 무슨 일 있어요 	무슨 일 있는지	0
종목의 선택이 특히 중요해	종목 선택 중요한지	0
다같이 모여서 공부하는 것이 효과가 있을까 	다같이 공부 효과 여부	2
어제 은행 가서 통장 해약했어	어제 은행 가서 통장 해약했는지	0
보험 종류에는 종신보험 외에 또 어떤 것들이 있지요	종신보험 외 보험 종류	2
미경이 학교 선생님 됐데 	미경이 학교 선생님 됐는지	0
민자가 어젯밤 메일을 몇 통이나 보냈어	민자가 어젯밤 보낸 메일 수	2
넌 내일 쉬는 날이지	내일 쉬는 날인지	0
시민의 숲 개장일이 언제니	시민의 숲 개장일	2
교통문화 선진국의 시민들은 교통법규를 잘 지킬까	교통문화 선진국의 시민들 교통법규 잘 지킬지	0
주유 할인 및 영화 할인하는 신용카드는 없나요 	주유 할인 및 영화 할인하는 신용카드	2
금리가 오르면 채권 값이 떨어지는 이유가 뭐야 	금리 오르면 채권 값 떨어지는 이유	2
병목 정체를 보이는 구간은 어디지	병목 정체 구간	2
공식적입니까 비 공식입니까 	공식적인지 비공식인지	1
내 생일은 무슨 요일이니	내 생일 요일	2
방학 때 이번에도 외국 여행 갈 거야 	방학 때 외국 여행 가는지	0
요즘 반신욕 하는 게 유행이래	요즘 반신욕 유행인지	0
여기는 도대체 이자가 몇 프로라는 거야	이자 몇 프로인지	2
수진이 아버님은 완쾌 되셨니	수진이 아버님 완쾌 여부	0
엄마 이번에 점수 오르면 반지 사준다는 약속 유효하지요 	점수 오르면 반지 사주는지	0
이천 사 시즌 투수의 순위에 대해 알려	이천 사 시즌 투수 순위	2
다음 주의 전국 날씨가 어떻지	다음 주 전국 날씨	2
남산 삼 호 터널은 원활하니	남산 삼 호 터널 원활한지	0
지금 도착해	지금 도착하는지	0
이 대리 일일 업무 보고 어떻게 됐어	일일 업무 보고 경과	2
오늘 서울 날씨는 어때	오늘 서울 날씨	2
사표 언제쯤 내는 게 좋을까	사표 내기 좋은 시기	2
송정 바닷가 부근 레스토랑은 어디	송정 바닷가 부근 레스토랑	2
현장학습 계획을 세울 때 필요한 게 무엇이 있나요 	현장학습 계획 세울 때 필요한 것	2
첫 월급은 부모님을 위해 쓸 거야	첫 월급 부모님을 위해 쓸지	0
금요일까지면 충분해	금요일까지면 충분한지	0
그 영화 봤니	그 영화 봤는지	0
가락시장 근처의 전통 음식점 어떻게 가는가	가락시장 근처 전통 음식점 가는 방법	2
졸업 학점이 몇 학점이지	졸업 학점	2
그 쪽으로 가면 막혀	그 쪽으로 가면 막히는지	0
서울대 인근 당구장 어떻게 가	서울대 인근 당구장 가는 방법	2
너 주식 빨간색이야 파란색이야 	주식 빨간색인지 파란색인지	1
우리 동네는 고기 뷔페 집이 없어	우리 동네 고기 뷔페 집 없는지	0
정형외과와 한의원 중 어디가 좋을까요	정형외과 한의원 중 좋은 것	1
어제 그 영화 봤어	어제 그 영화 봤는지	0
오늘 웃찾사 하는 날이야	오늘 웃찾사 하는 날인지	0
명절 잘 지냈어	명절 잘 지냈는지	0
약속장소 까지 지하철이 빠를까 버스가 빠를까	약속장소까지 지하철 버스 중 빠른 것	1
학습과제의 분석물을 어느 분께 드리면 되죠	학습과제 분석물 줄 사람	2
지금 시작된 건조 주의보가 얼마나 갈까	건조 주의보 지속 기간	2
오늘 생활한자 뭐지	오늘 생활한자	2
내일 계모임이 장소가 어디지	내일 계모임 장소	2
냉장고 온도가 어떻지	냉장고 온도	2
술 한잔 할까 아니면 근사한 레스토랑 갈까	술 한잔 할지 근사한 레스토랑 갈지	1
증권계좌로의 계좌이체는 인터넷에서만 가능하니 	증권계좌 계좌이체 인터넷 외 가능한 곳	2
분당구청은 어디지	분당구청 위치	2
돈 있어	돈 있는지	0
너 수영 꽤 오래했지 어때 살 좀 빠졌냐 	살 빠졌는지	0
부산 시내 정체구간 얼마나 되냐	부산 시내 정체구간	2
벌써 아르바이트 구했구나 어떤 아르바이트야 	아르바이트 정체	2
우리 곗돈 국민은행에 통장 만들어서 맡길까 	곗돈 국민은행에 맡길지	2
오전에 갈까 오후에 갈까 열 두시쯤에 어때	오전에 갈지 오후에 갈지	1
보험 가입 하면 뭐가 좋지 	보험 가입 장점	2
기숙사에 바퀴벌레가 나온다던데 괜찮니 	기숙사 바퀴벌레 괜찮은지	0
삼순이 재방송 언제해	삼순이 재방송 날짜	2
버스가 좋을까 지하철을 타고 가는 것이 빠를까	버스가 빠를지 지하철이 빠를지	1
동대에서 가장 싼 술집 어디지	동대 가장 싼 술집	2
주식형 펀드와 적금 중에 뭘 하는게 좋을까	주식형펀드 적금 중 할 것	1
지금 연세대 앞에 차가 막히니	지금 연세대 앞 차 막히는지	0
팔 인실로 예약 변경해	팔 인실로 예약 변경할지	0
스테미너 건강 관리법은 뭐가 좋지 	스테미너 건강 관리법 장점	2
오늘 야간 자율학습 안 한데	오늘 야간 자율학습 여부	0
비상장 주식일 경우에도 스탁옵션 행사가 가능할까요 	비상장 주식 스탁옵션 행사 가능 여부	0
구리에 있는 엘지전자 서비스센터는 어떻게 가지	구리 엘지전자 서비스센터 가는 방법	2
남산공원 가는 길 정체되는지 알 수 있을까	남산공원 가는 길 정체 여부	0
어떻게 된 거야	상황	2
난 자전거 못 타는데 자전거 탈 줄 알아야 해 	자전거 탈 줄 알아야 하는지	0
주 야간 교차수강도 가능해	주 야간 교차수강 가능 여부	0
은정이와 에버랜드 가기로 한 날이 언제지	은정이와 에버랜드 가기로 한 날	2
우리 회사는 아넬바랑 기술 제휴 맺고 있는 거 맞죠	우리 회사 아넬바랑 기술 제휴 맺었는지	0
주식 온라인 수수료가 가장 싼 데 알아 	주식 온라인 수수료 가장 싼 곳	2
장외 주식시세에 대해서 알고 싶어	장외 주식시세 알고 싶은지	0
나올 수 있어	나올 수 있는지	0
웨딩촬영 스튜디오에다 예약했어	웨딩촬영 스튜디오 예약 여부	0
야유회에 김밥을 싸가려고	야유회 김밥 싸가는지	0
대출 받으려고 하는데 어느 은행이 제일 좋으니 	대출 받기 좋은 은행	2
삼십일 부산의 비 올 확률은	삼십일 부산 비 올 확률	2
인터넷 쇼핑에서 물건사고 계좌이체 결제했어	인터넷 쇼핑 계좌이체 결제 여부	0
피겨 스케이팅에 대한 기사는 없을까	피겨 스케이팅 기사	2
현재 전체 메일이 몇 통이니	현재 전체 메일 통 수	2
서울대 주변 나이트 클럽 어디니	서울대 주변 나이트클럽	2
어제 보낸 메일 중 수신 확인된 메일 몇 통이냐	어제 보낸 메일 중 수신 확인된 메일 수	2
연말 보너스 몇 퍼센트인지 혹시 알아 	연말 보너스 퍼센트	2
채권형 펀드 운용성과가 어떻게 되지 	채권형 펀드 운용성과	2
오늘 종목별 경기결과 어떨지	오늘 종목별 경기결과	2
부산까진 뭐 타고 갈까 	부산 타고 갈 것	2
주말에 은행 업무를 하는 곳이 없나 	주말 은행 업무 하는 곳	2
어제 중국으로 출장 갔어	어제 중국으로 출장 갔는지	0
어젯밤 이메일 중 첨부 파일이 든 이메일은 얼마나 돼니	어젯밤 이메일 중 첨부 파일이 든 이메일 수	2
다음 주의 전국 날씨가 어떻지	다음 주 전국 날씨	2
과천 가려면 또 갈아타야 하나	과천 가려면 또 갈아타야 하는지	0
우리 에프티피 패스워드가 뭐죠	에프티피 패스워드	2
오늘 달러 환율 얼마예요	오늘 달러 환율	2
너 어디야 왜 아직도 안 나오는 거야 	현재 위치	2
오늘 사회면 주요 소식 뭐냐	오늘 사회면 주요 소식	2
거의 다 왔어	거의 다 왔는지	0
나 오늘 꼭 가야 하니 비도 오고 엄청 귀찮구나	오늘 꼭 가야 하는지	0
너희 집에서 다섯 시쯤 볼까	다섯 시쯤 볼지	0
그 수업 시간에 애들이 너무 떠들지 않니 	수업 시간 애들 너무 떠들지 않는지	0
주식계좌 만들려면 뭐 필요해	주식계좌 만들려면 필요한 것	2
오늘은 맑아요	오늘 맑은지	0
다른 주식은 다 오르는데 왜 내 것만 떨어지지	내 주식 하락 이유	2
학교에 지각을 할 것 같은데 너는 도착했니 	학교 도착 여부	0
페스트푸드는 전혀 안 먹어	페스트푸드 전혀 안 먹는지	0
무교동에 있는 서린낙지는 어떻게 가지	무교동 서린낙지 가는 방법	2
관광 버스가 있나요	관광 버스 여부	0
동작대교 북단 상습 정체구간이니	동작대교 북단 상습 정체구간 여부	0
이번에 결혼한다던데 며칠이야 	결혼 날짜	2
스쿼시에 대한 기사가 있니	스쿼시 기사 여부	0
외국에서 빨리 돌아 왔으면 좋겠어 	외국에서 빨리 돌아 왔으면 좋겠는지	0
요새 장사 잘 되냐 연락 없는 거 보니까 엄청 바쁜가 보네 	장사 잘 되는지	0
인터넷쇼핑몰은 계좌번호를 어떻게 알아 	인터넷 쇼핑몰 계좌번호 아는 방법	2
좀 된 건가요	좀 됐는지	0
오늘 배드민턴 경기에 관한 기사는	오늘 배드민턴 경기 관한 기사	2
내일 비 온데	내일 비 오는지	0
홍은동 녹번역 구간 교통상황은 어때	홍은동 녹번역 구간 교통상황	2
증권 정보 사이트 어디가 좋은가요	좋은 증권 정보 사이트	2
의정부에 소재하는 부대찌게 전문점 어떻게 가	의정부 소재 부대찌게 전문점 가는 방법	2
부산시 진입로 정체구간 얼마나 되니	부산시 진입로 정체구간 정도	2
환전해야 되는데 외환은행 말고도 할 수 있지	외환은행 외 환전 가능 여부	0
애인 조카녀석 학교 졸업식이 언제야	애인 조카 학교 졸업식 날짜	2
서초구 서초동 근처 고깃집 어디니	서초구 서초동 근처 고깃집 위치	2
곧 큰 눈이 온다는데 자동차에 체인은 사셨어요	자동차 체인 샀는지	0
기상청 슈퍼컴퓨터 본 적 있어	기상청 슈퍼컴퓨터 본 적 있는지	0
셔틀버스 타려고 줄 서 있어	셔틀버스 타려고 줄 서 있는지	0
업무 안내는 제대로 되는 거야	업무 안내 제대로 되는지	0
영국 연수까지 얼마나 남았지	영국 연수까지 남은 기간	2
아까 받은 프린트 읽어봤어	아까 받은 프린트 읽어봤는지	0
예전에는 말랐었는데 살 좀 쪘어 	살쪘는지	0
왜 전화 안해	전화 안하는 이유	2
어제도 무단결근이더니 오늘은 또 왜 안 나와 	오늘 안 나오는 이유	2
대학 경쟁력과 관련된 특집기사는 뭘까	대학 경쟁력 관련 특집기사	2
주식매수청구권 처분했어	주식매수청구권 처분 여부	0
제기동에서 제일 좋은 한약상은 어디지	제기동에서 제일 좋은 한약상	2
약은 먹었어	약 먹었는지	0
알았어요 얼마나 되죠	가격	2
발리댄스나 배워 볼래	발리댄스 배울지	0
실장님이 뭐라고 안 해	실장님 질책 여부	0
외국어 말고도 필요한 것이 뭐가 있지 	외국어 외 필요한 것	2
병원 예약하고 기다리는 중이야	병원 예약하고 기다리는 중인지	0
석유 파동 아직도 인거야	석유 파동 지속 여부	0
정말 보기 싫어	보기 싫은지	0
종로 근처에서 가장 비싼 호텔은 어디지	종로 근처 가장 비싼 호텔	2
주식형 펀드와 적금 중에 뭘 하는게 좋을까	주식형펀드 적금 중 할 것	1
김동성 선수의 요즘 근황은 어떻지	김동성 선수 근황	2
김대리가 일이 있대서 바꿔줬어	김대리가 일이 있대서 바꿔줬는지	0
요번 시험에 승규가 일등 했어	요번 시험 승규 일등 했는지	0
남자친구가 춥다고 손난로 좀 보내달라는데 열내는하마 그런거 사면되나	남자친구 보내줄 손난로	2
시험 잘 봤니	시험 잘 봤는지	0
지금 서울은 몇 도지	지금 서울 온도	2
보통주와 우선주는 뭐가 다른 거지 	보통주 우선주 차이점	2
스키어들의 사고 유형을 잘 파악하고 있어 	스키어 사고 유형 파악하고 있는지	0
코미디 물인가요	코미디물 여부	0
행주대교 남단 교통 흐름이 어떨까	행주대교 남단 교통 흐름	2
모의 투자는 반드시 겪어야해	모의 투자 반드시 겪어야하는지	0
시간외 거래 수수료가 얼만데	시간외 거래 수수료	2
요즘에 은행 새로 나온 상품 뭐가 있어	요즘 은행 새 상품	2
위안화 환전은 마쳤니	위안화 환전 마쳤는지	0
신용카드 부가적 혜택은 살펴봤어 	신용카드 부가적 혜택 살펴봤는지	0
짜증나	짜증나는지	0
성탄절 카드를 보냈는데 받았니 	성탄절 카드 받았는지	0
이 편지는 저한테 온 건가요	편지 저한테 왔는지	0
장기투자와 단기투자 중 뭘 할 거야	장기투자 단기투자 중 할 것	1
요즘 하는 수목드라마 중에서 해신이 시청률 일 위래	수목드라마 중 해신 시청률 일 위인지	0
선생님이 요점 정리 해주신데	선생님 요점 정리 해주시는지	0
잘 도착했어요	잘 도착했는지	0
대동병원 근처 꽃집 어디지	대동병원 근처 꽃집	2
한 시간 전 교통정보 상황은 어때	한 시간 전 교통정보 상황	2
다음 달 증시의 전망과 투자 전략이 궁금해	다음 달 증시 전망 투자 전략	2
너 요즘도 매일 저녁 반신욕 하는 거야 	매일 저녁 반신욕 하는지	0
사고 처리중이야	사고 처리중인지	0
남산공원 근처 편의점은 어떻게 간데	남산공원 근처 편의점 가는 방법	2
너는 어느 은행에서 주로 금융거래 하니	주거래은행	2
이번에 학교에서 하는 스노보드 강좌 들었니	이번 학교 스노보드 강좌 들었는지	0
그 학원엔 유명한 강사들이 많대	그 학원 유명 강사 많은지	0
이번 달에 정윤이로부터 이메일이 몇 통왔지	이번 달 정윤이 이메일 수	2
시험 범위가 어디까지냐	시험 범위	2
이 줄은 뭐에요	줄 정체	2
보스턴까지 왕복표는 얼마에요	보스턴 왕복표 가격	2
오빠 요새 잘 지내고 있나요	잘 지내는지	0
영아에게 이메일 보냈니	영아에게 이메일 보냈는지	0
도대체 어디야 여기 왜 이렇게 차가 많니 	여기 차 많은 이유	2
백두산 한 달 여행비용은	백두산 한 달 여행비용	2
에이티엠 몇 시부터 수수료 붙지	에이티엠 수수료 붙기 시작하는 시각	2
잘 지내는지 궁금하네	근황	2
잠실에 있는 까르푸는 어떻게 간데	잠실 까르푸 가는 방법	2
위탁계좌는 어떻게 만들면 되는 거야 	위탁계좌 만드는 방법	2
나중에 뉴질랜드 가면 번지 점프 해 볼 거야	나중에 뉴질랜드 가면 번지 점프 해 볼지	0
머리 아파	머리 아픈지	0
순매수 규모가 어느 정도로 커 	순매수 규모	2
왜 아직도 안와 	안 오는 이유	2
교통카드가 쌀까요 전철표가 쌀까요	교통카드 전철표 중 싼 것	1
영화 본 후에 제가 태워 드릴까요 	영화 본 후 태워 줄지	0
이 금액은 뭐죠	금액 정체	2
너 혼자야	혼자인지	0
밤 꼬박 샜어	밤 꼬박 샜는지	0
현재 중부 상행선 교통 통제 구간은 어때	중부 상행선 교통 통제 구간 상황	2
요즘은 하루에 몇 킬로씩 뛰세요	요즘 하루 뛰는 거리	2
부가세 내는 달이 언제야	부가세 내는 달	2
성인 요금 얼마니	성인 요금	2
노동부에서 실업자 교육하는 거 있던데 배울까 	노동부 실업자 교육 배울지	0
다음 주 파리 날씨는	다음 주 파리 날씨	2
동서대 근처 내과는 어떻게 갈까	동서대 근처 내과 가는 방법	2
학교에서 보건검사를 한다던데 어디로 가야하니 	학교 보건검사 위치	2
열쇠는 경비실에 맡겼어	열쇠 경비실에 맡겼는지	0
왜 올 겨울엔 눈이 펑펑 안 오는 거지 	올 겨울 눈 펑펑 안 오는 이유	2
네 시 어떠세요	네 시 어떤지	0
도대체 왜 돈을 안 보내는거야	돈을 안 보내는 이유	2
병원 가서 치료 완료했어	치료 완료 여부	0
막내의 결혼식은 며칠이지	막내 결혼식 날짜	2
겨울의 꽃샘추위도 다 가고 잘 지내세요	잘 지내는지	0
영민이 위해 교육 보험은 어때요	교육 보험 어떤지	0
운전 면허 금방 딸 수 있어	운전 면허 금방 딸 수 있는지	0
어젯밤 새메일이 몇 통이 왔니	어젯밤 새 메일 수	2
부산에 일마레는 어디에 있어	부산 일마레 위치	2
공부하기 싫어	공부하기 싫은지	0
내일 클럽활동 뭐하니	내일 하는 클럽활동	2
오늘의 습도 얼마나 돼	오늘의 습도	2
오늘 아침의 기온은	오늘 아침 기온	2
내일 파리의 날씨 어떨까	내일 파리 날씨	2
신경 쓰여	신경 쓰이는지	0
도쿄까지 앞으로 몇 시간 걸리죠	도쿄까지 앞으로 걸리는 시간	2
내일 아침 지역별 안개 분포는 어떻지	내일 아침 지역별 안개 분포	2
화분 같은 거 잘 못 키워	화분 같은 거 잘 못 키우는지	0
버스로 올 거야 택시로 올 거야	버스 택시 중 타고 올 것	1
신용카드는 스물 여섯 살 이상이 돼야지 만들 수 있어	신용카드 스물 여섯 살 이상 돼야 만들 수 있는지	0
바비큐 그릴은 제공되니	바비큐 그릴 제공 여부	0
삼성전자 유상증자 언제 해	삼성전자 유상증자 시기	2
베개와 건강의 연관성은 어느정도 될까 	베개 건강 연관성	2
동아대 근처 많이 가는 밥집 어떻게 가는가	동아대 근처 많이 가는 밥집 가는 방법	2
회사에서 해외 연수 보내 주기로 했어	회사에서 해외 연수 보내 주기로 했는지	0
사진은 언제 다 되나요	사진 다 되는 시기	2
인천공항 근처 롯데리아는 어떻게 가는가	인천공항 근처 롯데리아 가는 방법	2
너 어디서 뭐 하고 지내는 거야	근황	2
골프연습장이 어디가 괜찮지	괜찮은 골프 연습장	2
내일 날씨 전망이 어떻게 되지	내일 날씨 전망	2
왜 이번 시험은 갑자기 문제를 어렵게 내셨을까 	이번 시험 문제 어렵게 낸 이유	2
앞의 렌즈가 움직여 거리를 조정할 수 있다구요	앞의 렌즈가 움직여 거리 조정 가능한지	0
내일 저녁 어떠세요	내일 저녁 어떤지	0
신한카드는 해외에서도 사용할 수 있어	신한카드 해외 사용 가능 여부	0
오늘 비온데	오늘 비오는지	0
서울역 근처 함흠냉면집 어떻게 가니	서울역 근처 함흠냉면집 가는 방법	2
휴지통에 있는 메일이 몇 개 있어	휴지통에 있는 메일 수	2
대구역 앞 일식집은 어떻게 간데	대구역 앞 일식집 가는 방법	2
전신마취도 해야 된대	전신마취도 해야 되는지	0
계좌이체를 하려면 어떻게 해야 할까	계좌이체 방법	2
아침마다 뒷산 올라갔다 와	아침마다 뒷산 올라갔다 오는지	0
지금 어디까지 오셨어요	어디까지 왔는지	0
워킹비자로 장사할 수 있나요 	워킹비자 장사 가능 여부	0
요즘 건강은 어때	요즘 건강	2
너는 입원 할 생각 없니	입원 계획 여부	0
지금 티브이를 보고있는 사람은 누구야	지금 티브이 보고있는 사람	2
카폰도 이용 가능하니	카폰 이용 가능 여부	0
파란색 서류파일 본 사람없데	파란색 서류파일 위치	2
버스와 전철 중 이용량이 더 많은 것은 무엇일까 	버스 전철 중 이용량 더 많은 것	1
요새 몸이 너무 안 좋아서 어떻게 해야 할지 모르겠어	몸이 안 좋을 때 대책	2
재무와 회계업무는 어떻게 다르죠 	재무 회계업무 차이	2
마포 소재 갈비집은 어떻게 가	마포 소재 갈비집 가는 방법	2
한사람도 없어	한사람도 없는지	0
수업 내용분 자료 찾고 책 읽었니 	수업 내용분 자료 찾고 책 읽었는지	0
기장 근처 재래 시장은 어디	기장 근처 재래 시장	2
고용보험 교육비는 회사에서 내 주는 거야 	고용보험 교육비 회사에서 내 주는지	0
정확히 몇 시에 끝나는 거야	끝나는 정확한 시간	2
퀵 서비스 불러서 사람 타고 가도 되려나 	퀵 서비스 불러서 사람 타고 가도 될지	0
담당교수님의 성함이 뭐지	담당교수 성함	2
대구역 앞 일식집은 어떻게 간데	대구역 앞 일식집 가는 방법	2
요즘 택시회사들의 운영정보를 알 수 있을까요 	요즘 택시회사들 운영정보	2
이 책에 나와 있는게 도움이 될까 	이 책에 나와 있는 게 도움 될지	0
날씨가 흐려서 노출을 어디에 맞춰야 할지 모르겠어	노출 맞출 곳	2
택시는 미터기의 요금만 내면 돼	택시는 미터기 요금만 내면 되는지	0
서울 가는데 버스가 좋을까 전철이 좋을까	서울 가는데 버스 전철 중 좋은 것	1
지금 거래처에 계약하러 가	지금 거래처에 계약하러 가는지	0
외국인이 파는 이유가 뭘까	외국인이 파는 이유	2
일년 장학금 받게 됐어	일년 장학금 받는지	0
세탁기가 얼마나 돌았지	세탁기 돈 정도	2
그럼 고속도로랑 국도 중에 어느 쪽이 더 빠를 거 같애	고속도로 국도 중 빠른 곳	1
자동차 말고 다른 교통 수단은 뭐가 있지 	자동차 외 교통 수단	2
이천 오년 시월 일일이 무슨 요일인가	이천 오년 시월 일일 요일	2
교내에 자동 입출금기가 어디 있지	교내 자동 입출금기 위치	2
좀 춥긴 한데 괜찮아	추운데 괜찮은지	0
할만해	할만한지	0
지난번 교통사고 나신 후에 휴유증은 없으시고요 	지난번 교통사고 후유증 여부	0
대학 졸업식이 언제쯤이지	대학 졸업식 시기	2
요즘 일이 많이 바쁘 시죠 	요즘 일 바쁜지	0
요즘엔 컴퓨터도 학원에서 배워야 한다더라 사실일까	컴퓨터 학원에서 배워야 하는지	0
가는길 알아	가는길 아는지	0
울산 무거동에 가면 우리은행이 있나	울산 무거동 우리은행 여부	0
분반 테스트 결과 어떻게 나왔어	분반 테스트 결과	2
갈아타는 곳은 어디에요	갈아타는 곳	2
그 교수님 수업 괜찮니	교수님 수업 괜찮은지	0
주식이 타 금융기관 상품과 틀린 점은 무엇입니까 	주식 금융기관 상품 차이점	2
약속 취소됐어	약속 취소 여부	0
신일아 요즘 대리운전 얼마쯤 하냐	요즘 대리운전 가격	2
나한테 이자가 붙게 되어있어	나한테 이자가 붙게 되어있는지	0
내일도 모레도 계속 비 온대	내일 모레 계속 비 오는지	0
공동구매로 사면 훨씬 쌀 거야 그러니까 너도 살래 	공동구매 여부	0
할부로 샀어	할부로 샀는지	0
서울역 근처 찜질방 어디일까	서울역 근처 찜질방 위치	2
을지로 입구 정체가 심해	을지로 입구 정체 심한지	0
기업 분석 자료는 연말에 나오나요 	기업 분석 자료 연말에 나오는지	0
가락시장 횟집 어떻게 가지	가락시장 횟집 가는 방법	2
돈이 들어있나요	돈이 들었는지	0
용산 가려면 뭐 타고 가면 될까	용산 가는 방법	2
독어 회화 수업이 언제까지야	독어 회화 수업 끝나는 시간	2
마포 소재 갈비전문점 어떻게 가냐	마포 소재 갈비전문점 가는 방법	2
막내의 담임 선생님의 가정방문 날짜는 언제야	막내 담임 선생님 가정방문 날짜	2
급행 요금은 얼마에요	급행 요금	2
증권거래소 최초 상장기업은 어디니	증권거래소 최초 상장기업	2
주요 도시 강수 분포도 어떤가	주요 도시 강수 분포도	2
계약 위반이라고 위약금을 요구하는데 어떡하지 	위약금 요구 대책	2
반신욕하니까 피부가 좋아져	반신욕 피부가 좋아지는지	0
독감 예방 주사 맞았어	독감 예방주사 맞았는지	0
오늘 동경의 날씨가 어떨까	오늘 동경 날씨	2
선경이 올 오월에 결혼해요	선경이 올 오월 결혼 여부	0
청담동 근처 유명한 카페 어떻게 가지	청담동 근처 유명한 카페 가는 방법	2
현재 춘천댐의 수위는	현재 춘천댐 수위	2
과연 내일 화이트 크리스마스가 될 수 있을까	내일 화이트 크리스마스 가능 여부	0
미 상공회의소 회장과 인터뷰 기사는 뭘까	미 상공회의소 회장 인터뷰 기사 정체	2
점심시간에 매점에서 뭐 먹지	점심시간 매점 먹을 것	2
청담동에서 가장 유명한 네일숍은 어딘데	청담동 가장 유명한 네일숍	2
너 밖에 없어	혼자인지	0
내일 서해안에 태풍 주의보가 내려졌니	내일 서해안 태풍주의보 여부	0
신세계 백화점 근처 전통 음식점 어딘데	신세계 백화점 근처 전통 음식점	2
이번 합창대회 때 우리반이 우승할 수 있을까	합창대회 우리반 우승 가능 여부	0
동래에서 부산대 방면 가장 막히는 구간은	동래에서 부산대 방면 가장 막히는 구간	2
점심때나 돼야 갈 것 같아	점심때 갈 것 같은지	0
오늘의 습도 얼마지	오늘 습도	2
어제 과음한 것 같은데 속은 좀 어때 	속 상태	2
청담동 근처 네일숍은 어디니	청담동 근처 네일숍 위치	2
오늘 설계는 휴강이래	오늘 설계 휴강인지	0
학습지는 뭐가 제일 좋은 것 같아	제일 좋은 학습지	2
카드 값 갚아야 돼	카드 값 갚아야 되는지	0
내가 저녁에 운동하는 날짜가 언제지	내 저녁 운동 날짜	2
금일 주가에 영향을 미칠만한 정치적인 일들은 뭐가 있어	금일 주가 영향 미칠만한 정치적인 일	2
통장 해약하려 인감 필요해	통장 해약 인감 필요 여부	0
운동을 시작하려는데 헬스클럽과 요가 중에 어떤 것이 좋을까	헬스클럽 요가 중 좋은 것	1
다리에 쥐났던 건 괜찮아졌어 	다리 쥐 괜찮은지	0
스쿼시 배워보는 건 어때	스쿼시 어떤지	0
장전동 부근 무료 신문 배포소는 어떻게 가	장전동 부근 무료 신문 배포소 가는 방법	2
수학은 예습이 잘 안 돼요	수학 예습 잘 안되는지	0
너 지금 주식에 투자하는 돈이 유휴 자금이냐 	지금 주식 투자 유휴 자금인지	0
주식에 투자하는 것과 저축하는 것 중 어느 것이 나을까	주식투자 저축 중 나은 것	1
오늘 자외선 지수는 어떻게 될까	오늘 자외선 지수	2
무슨 말이죠	말의 의미	2
청담동에 가려면 뭐 타고 가야 하냐 	청담동 타고 갈 것	2
어느 정도 이익 실현이 가능해요	이익 실현 가능한지	0
오래된 계좌도 쓸 수 있을까 	오래된 계좌 사용 가능 여부	0
교통사고에 의한 법적소송의 자세한 예가 없을까요 	교통사고 법적소송 자세한 예	2
수영 한 달 강습비가 얼마쯤 되죠	수영 한 달 강습비	2
빼빼로 데이가 언제인가	빼빼로 데이 날짜	2
지금 동국대 앞 소통이 원활하니	동국대 앞 소통 원활 여부	0
학교 끝나고 독서실이야	독서실인지	0
그럼 아예 영화 여러 개 볼까 	영화 여러 개 볼지	0
대학 등록금 납부일이 언제까지야	대학 등록금 납부 기한	2
그 서류 결재 받으셨어요	그 서류 결재 받았는지	0
저번 해에 지방세를 얼마를 냈는지 기억이 안 나	저번 해 낸 지방세	2
차가 주차가 잘되어 있니	주차 잘되어 있는지	0
방 값은 얼마니	방 값	2
새 메일 중 정보라는 단어가 든 이메일 얼마나되	새 메일 중 정보라는 단어 든 이메일 수	2
학교 다니기 힘들다 너는 	학교 다닐 만한지	0
핸드볼 국가대표 감독에 관한 기사가 있니	핸드볼 국가대표 감독 기사	2
어느 길로 가야 가장 빨리 갈 수 있을까 	가장 빨리 갈 수 있는 길	2
당행 이체하면 수수료 없어	당행 이체 수수료 여부	0
이 쇼핑몰은 농협계좌밖에 없어	이 쇼핑몰 농협계좌밖에 없는지	0
환전 수수료는 얼마나 붙을까 	환전 수수료	2
저녁에 운동장 매일 열 바퀴씩 뛰어	저녁에 운동장 매일 열 바퀴씩 뛰는지	0
그럼 면허 취소당하는 거야 	면허 취소당하는지	0
이번 달의 쇼핑 이메일 전부 삭제할까	이번 달 쇼핑 이메일 전부 삭제할지	0
내일의 자외선 지수는 얼마나 되지	내일 자외선 지수	2
이번 달에 병원 진료 일정이 잡혀있니	이번 달 병원 진료 일정 잡혀있는지	0
장외 시장은 아직 잠잠해	장외 시장 아직 잠잠한지	0
그 업체는 오늘도 소식 없어	그 업체 소식 없는지	0
서울 종로 음식점은 어떻게 가니	서울 종로 음식점 가는 방법	2
군대 다녀오면 그렇게 추워도 견딜 수 있어	군대 다녀오면 추워도 견딜 수 있는지	0
부산에서 분위기가 제일 좋은 호텔 바는 어디지	부산 분위기 좋은 호텔 바	2
안에는 뭐가 들었나요	안에 든 것	2
우리 회사랑 계약하기로 했어	우리 회사랑 계약하기로 했는지	0
중국에 가려면 배타고 얼마나 걸릴까	중국 배타고 가면 걸리는 시간	2
새로운 공구 메일이 도착한 게 있니	새로운 공구 메일 도착한 게 있는지	0
예술의전당에서 유명한 전시회 한데	예술의전당 유명한 전시회 하는지	0
만나고 싶어	만나고 싶은지	0
여름방학은 언제쯤 끝이야	여름방학 끝나는 시기	2
정기적금과 정기예금의 차이점이 뭔지 아니 	정기적금 정기예금 차이점	2
이걸로 흰색 있나요	이걸로 흰색 있는지	0
이 편지는 저한테 온 건가요	저에게 온 편지인지	0
팔월 일일에 예약했어	팔월 일일 예약했는지	0
강남구청 가려면 버스와 지하철 중 어느 쪽이 더 나은가요	강남구청 가려면 버스 지하철 중 나은 것	1
부산 가는 비행기 하루에 몇 회 운행이야	부산 가는 비행기 하루 운행 횟수	2
서울 부산 고속철 운임 얼마니	서울 부산 고속철 운임	2
음력 칠월 칠일이 양력으로 며칠이지	음력 칠월 칠일 양력 날짜	2
서울광장 앞 도로 상황이 어떠니	서울광장 앞 도로 상황	2
내일 태현이랑 만나기로 한 장소가 어디지	내일 태현이 만나는 장소	2
이번주에 이발소 가는날이지	이번주 이발소 가는날인지	0
현재 침수된 대교는	현재 침수된 대교	2
공정거래위원회에 제출할 소명서는 마무리 되어 갑니까	소명서 마무리 여부	0
베컴 관련 기사는 없을까	베컴 관련 기사 여부	0
걱정 안해	걱정 안하는지	0
임용고시 준비는 잘 되가	임용고시 준비 잘 되가는지	0
이 전화로 직통 시외 전화 걸려면 어떻게 해야 하나요	직통 시외 전화 거는 방법	2
내년 설 연휴가 며칠이니	내년 설 연휴 날짜	2
비자 신청해	비자 신청하는지	0
오늘의 종목별 경기결과 어떨지	오늘 종목별 경기결과	2
친구 아버님이 병원에 계셔	친구 아버님 병원에 계신지	0
전화해	전화할지	0
오늘이 며칠인데	오늘 날짜	2
오늘 경기 비와서 취소 됐니 	오늘 경기 취소 여부	0
다음 주 계모임 장소는 어디지	다음 주 계모임 장소	2
졸업을 하려면 전공과목을 모두 몇 학점 신청해야 해 	졸업 전공과목 신청 학점 수	2
마을버스 운행시간 아니	마을버스 운행시간	2
막내는 며칠에 출장을 떠날껀데	막내 출장 떠나는 날짜	2
해외 펀드 종류는 다양한 편이니 	해외 펀드 종류 다양한지	0
혹시 십육 일 날 학교 가시나요	십육 일 날 학교 가는지	0
밥은 잘 먹고 다녀	밥은 잘 먹고 다니는지	0
이미지의 색상을 볼 수 있어	이미지 색상 볼 수 있는지	0
전자금융거래와 계좌 비밀번호를 다르게 사용해	전자금융거래 계좌 비밀번호 다르게 사용하는지	0
한겨울에 비가 내릴수 있을까	한겨울 비 내릴 수 있는지	0
주식이 과연 운일까 실력일까	주식이 운일지 실력일지	1
번호표 뽑고 기다리고 있어	번호표 뽑고 기다리고 있는지	0
과천에 있는 한식당 어디일까	과천 한식당 위치	2
고기보다는 야채를 많이 먹어	고기보다 야채 많이 먹는지	0
여기가 그 유명한 맛 집이야	여기가 유명한 맛집인지	0
낙성대 근처 가장 싼 음식점은 어디지	낙성대 근처 가장 싼 음식점	2
동의대 주변 플레이스테이션 방은 어떻게 가냐	동의대 주변 플레이스테이션방 가는 방법	2
시드니까지 할인 항공권 있나요	시드니까지 할인 항공권 여부	0
왜 통장이 많으면 부자라고 하지	통장 많으면 부자 이유	2
보낸 편지함에 메일 몇 개가 있니	보낸 편지함 메일 수	2
늦으면 벌금을 물릴 거예요	늦으면 벌금 있는지	0
요즘 운동 뭐하면 좋을까	요즘 하기 좋은 운동	2
소이 방 에어컨 십 분 뒤에 켤까	소이 방 에어컨 십분 뒤에 켤지	0
오늘 만조 시 수위는 얼마지	오늘 만조 시 수위	2
요즘 스톡옵션이 유행이야	요즘 스톡옵션이 유행인지	0
만화책도 국어 공부에 도움이 된대요	만화책 국어 공부 도움 여부	0
경남 마산에 수영장은 어딘데	경남 마산 수영장 위치	2
이 열차는 침대차 있나요	열차 침대차 여부	0
내일 부산 지역 일출 일몰 시간은	내일 부산 지역 일출 일몰 시간	2
보낸 메일 중 되돌아 온 메일은 몇 통일까	보낸 메일 중 되돌아 온 메일 수	0
잘 도착했어요	잘 도착했는지	0
이번 인터뷰 준비는 다 끝났지	이번 인터뷰 준비 다 끝났는지	0
현관을 지키고 있어	현관 지키고 있는지	0
시험 결과 어떻게 나왔니	시험 결과	2
너 네 집 근처에 한미은행 있지	집 근처 한미은행 여부	0
우체국과 은행 중 어디가 더 안전할까 	우체국 은행 중 안전한 곳	1
서울에 언제 도착해	서울 도착 시각	2
요번 주말에도 비가 그치지 않을 것 같다는 예보 봤니 	주말 비 예보 봤는지	0
경주에는 특산품 점이 많니	경주 특산품점 많은지	0
심하게 지체야	심하게 지체인지	0
안녕하세요 몇 분이신가요	인원	2
요즘 건강은 어때	요즘 건강	2
기차표 예약 해	기차표 예약하는지	0
선배 오늘 모임에 갈 거예요	오늘 모임 참석 여부	0
금융 공사 모기지론과 은행 대출 중 어느 것이 유리할까요	금융공사 모기지론 은행대출 중 유리한 것	1
야 여기서 안양 가려면 몇 번 버스 타야 돼	안양 가는 버스	2
열 바퀴 뛰고 나서 다시 해요	열 바퀴 뛰고 나서 다시 하는지	0
은행의 업무를 맡는 사람을 뭐라 불러 	은행 업무 맡는 사람 호칭	2
온라인 입금 시켜줄게 어디 은행이야 	온라인 입금 은행	2
남부 순환도로에 교통 사고 난 데 있나	남부 순환도로 교통 사고 여부	0
날씨도 좋은데 오늘 뭐하니	오늘 하는 것	2
오늘 주가 어떻게 되지	오늘 주가	2
대학 합격자 오늘 발표 나지 않던가	대학 합격자 오늘 발표 여부	0
자기야 사랑해	사랑하는지	0
강남으로 장소 바꿨어	강남으로 장소 바꿨는지	0
교통사고로 후유증이 생겼는데 보상해 주겠지 	교통사고 후유증 보상 여부	0
오전이랑 오후 중 언제가 편해	오전 오후 중 편한 때	1
너 뭐 타고 왔는데 이렇게 늦었냐	타고 온 것	2
요즘에 학교운동장 다섯 바퀴씩 뛰어	요즘 학교운동장 다섯 바퀴씩 뛰는지	0
서울에 아토피 전문클리닉이 있는 병원은	서울 아토피 전문클리닉 있는 병원	2
생각보다 날이 따뜻한데 야외로 나갈까 	야외로 나갈지	0
쉽게 할 수 있는 레져 스포츠 없어 	쉽게 할 수 있는 레져 스포츠	2
발품 파는 것보다 훨씬 싸게 살 수 있어	발품 파는 것보다 훨씬 싸게 살 수 있는지	0
신용불량자야	신용불량자 여부	0
허리 다쳤어	허리 다쳤는지	0
재테크 고수가 되려면 어떻게 해야 될까 	재테크 고수 되는 방법	2
저축이 나을까 적금이 나을까	저축 적금 중 나은 것	1
영어 단어 못 외워서 맞았다며 괜찮냐	괜찮은지	0
그 분야는 미래가 어둡다는데 왜 주식을 팔지 않는 거야 	그 분야 주식 팔지 않는 이유	2
날씨도 좋은데 데이트 약속 없어 	데이트 약속 여부	0
신촌에서 맛있는 치킨집은 어떻게 가니	신촌 맛있는 치킨집 가는 방법	2
나 척추 휜 거 같은데 어떻게 하지	척추 휠 때 대책	2
스키보드랑 숏 스키가 다른가요 	스키보드 숏 스키 차이점	2
오빠 엄마 아빠는 잘 계시고	엄마 아빠 잘 계신지	0
남산동 진입 구간 흐름은 어때	남산동 진입 구간 흐름	2
시험 날짜 확실한거야 	시험 날짜 확실한지	0
동아대 앞 중국집은 어떻게 가지	동아대 앞 중국집 가는 방법	2
자기야 많이 바뻐	많이 바쁜지	0
성적 증명서 한 부와 부전공 신청서를 내면 신청된대요	성적 증명서 한 부와 부전공 신청서를 내면 신청되는지	0
첨부 파일 든 메일 몇 통이래	첨부 파일 든 메일 수	2
오늘 태풍주위보가 해제되니	오늘 태풍주위보 해제 여부	0
자연 휴양림은 어떻게 가야지 빠른가요 	자연 휴양림 빨리 가는 방법	2
회사랑 관계없는 사람은 출입 못해	회사 관계없는 사람 출입 가능한지	0
아침마다 손도 붓고 얼굴도 부어 병원 가봐야 될까 	병원 가봐야 될지	0
답답해	답답한지	0
종로에서 제일 큰 약국은 어디야	종로 제일 큰 약국	2
지금 조금 위험한 것 같아	지금 위험한지	0
우리 회사 거래 은행이 어디입니까	우리 회사 거래 은행	2
막내학교는 언제 단체 영화 보러가니	막내학교 단체 영화 날짜	2
노후 자금의 규모는 어느 정도가 적당할까 	적당한 노후 자금 규모	2
오늘 뭐 먹을까 안 먹어본 거 먹고 싶다	오늘 먹을 것	2
물 좋아	물 좋은지	0
해외 증시 알아볼 만한 사이트가 어디 있을까	해외 증시 알아볼 만한 사이트	2
이번 수능 너무 어렵지 않았어	이번 수능 어려웠는지	0
잘 지내고 있어	잘 지내는지	0
내가 산 주식의 회사가 파산하면 어떻게 해야 하니 	주식 산 회사 파산 대책	2
경영학과 하계수련회 날짜는 언제지	경영학과 하계수련회 날짜	2
오늘 서울 지역 구름의 양은 얼마나 되지	오늘 서울 지역 구름의 양	2
경상도 쪽에서는 공기놀이를 살구라고 불러	경상도 공기놀이 살구라고 부르는지	0
오빠 저녁 드시고 오시는 거예요	저녁 먹고 오는지	0
백화점안에 창문이 없는 이유 알아	백화점 창문 없는 이유	2
혜화역 주변의 떡볶이집은 어떻게 가냐	혜화역 주변의 떡볶이집 가는 방법	2
개인이 해외 펀드에 투자할 수도 있대요	개인 해외 펀드 투자 가능 여부	0
내일은 그냥 집에서 뒹굴려고	내일 집에서 뒹굴지	0
서울 인사동 근처 바지락 칼국수집 어디니	서울 인사동 근처 바지락 칼국수집 위치	2
사랑해	사랑하는지	0
달러 환율이 낮아지면 해외송금 할 때 유리한가	달러 환율 낮아지면 해외송금 유리한지	0
서해안의 팔월 평균 해수온도는 어떻게 되지	서해안 팔월 해수온도	2
형 잘 지내고 있는 거예요 	잘 지내는지	0
오늘 새 편지 중 공지 메일을 찾는가	오늘 새 편지 중 공지 메일 찾는지	0
약속 시간 알고 있니	약속 시간 아는지	0
영순이에게서 답장이 왔을까	영순이 답장 왔는지	0
학습 효과를 극대화시키기 위해서 필요한 것은 무엇일까	학습 효과 극대화 위해 필요한 것	2
결혼식 약속은 언제지	결혼식 약속 시간	2
남산공원 근처 편의점은 어떻게 간데	남산공원 근처 편의점 가는 방법	2
학원 다니는 게 나을까 과외 나을까 	학원 과외 중 나은 것	1
정관이 제대일은 며칠이야	정관이 제대일	2
다음 고속도로 휴게실은 몇 킬로를 더 가야지 나오나요 	다음 고속도로 휴게실까지 남은 거리	2
요앞 주유소에서 알바생 구해	요앞 주유소에서 알바생 구하는지	0
엘지카드 아직 안 망했나	엘지카드 아직 안 망했는지	0
내가 산 주식은 왜 떨어지기만 하는지 모르겠어	내가 산 주식 떨어지는 이유	2
봄에는 자살률이 올라 간다던데 왜 그럴까 	봄 자살률 올라가는 이유	2
재경부 차관 면담 계획은 잡혔나	재경부 차관 면담 계획 잡혔는지	0
사용료는 잘 받는 거야	사용료 잘 받는지	0
알았어요 얼마나 되죠	가격	2
김약국네 딸이 정말 예뻐	김약국네 딸 예쁜지	0
제 자리는 어디에요	제 자리 위치	2
인터넷으로도 계좌이체 가능해	인터넷 계좌이체 가능한지	0
카드 값 어떻게 막지	카드 값 막는 방법	2
어느 나라로 유학 가는 게 좋을까 	유학 가기 좋은 나라	2
우리나라의 대통령 선거일은 언제인데	우리나라 대통령 선거일	2
정통부 사 세대 이동 통신개발과 관련된 소식 뭐니	정통부 사 세대 이동통신 개발 관련 소식	2
비행기 티켓 예약은 끝났어 	비행기 티켓 예약 끝났는지	0
오늘 저녁에 반창회 있어	오늘 저녁 반창회 있는지	0
여윳돈 있으면 너도 주식이나 한 번 해볼래 	주식 한번 해볼지	0
주요 도시의 강수 분포도 어떻게 되니	주요 도시 강수 분포도	2
어디서 볼까 난 아무데나 관계없어	볼 장소	2
세탁기에 빠져서 돈이 찢어졌는데 교환 받을 수 있나요 	찢어진 돈 교환 여부	0
그럼 너도 다음 주부터 주전 선수로 뛰는 거야	다음 주부터 주전 선수로 뛰는지	0
호남 고속도로의 상황은 어떠냐	호남 고속도로 상황	2
상품권 줄까	상품권 줄지	0
외국 나갈 땐 비상약은 챙겨가	외국 나갈 때 비상약 챙겨가는지	0
사업 잘 될까	사업 잘 될지	0
오늘 자외선 지수는 얼만데	오늘 자외선 지수	2
집에 들어가기 싫어	집에 들어가기 싫은지	0
그럼 나랑 김태희 중에 누가 더 예뻐 	나랑 김태희 중 예쁜 사람	1
언니가 입원한 병실이 몇 호야 	언니 입원 병실	2
그 외 업무는 다른 사람에게 맡겨	그 외 업무 다른 사람에게 맡길지	0
홍은동 녹번역 구간의 교통상황 어떻지	홍은동 녹번역 구간 교통상황	2
가입 환영 메일은 읽었어	가입 환영 메일 읽었는지	0
올해 설은 몇 월이야	올해 설 날짜	2
자가용을 끌고 갈까 버스를 타고 갈까	자가용 끌고갈지 버스 타고 갈지	1
지금 도시 고속도로가 원활하니	지금 도시 고속도로가 원활한지	0
겨울방학 내가 해야 할 공부가 뭐지	겨울방학 내가 해야 할 공부	2
중간고사 문제 어려웠어	중간고사 문제 어려운지	0
누구 일본말 할 줄 아는 분 계세요	일본말 가능 여부	0
천성산 늪에 갈려면 어떻게 가야되	천성산 늪 가는 방법	2
언제 먹을 거야	먹을 시각	2
부산까지 가면 고속도로 통행료 얼마야	부산까지 고속도로 통행료	2
무슨 운동을 하기로 되어 있는 날이지	예정 운동	2
다음달 장날이 언제야	다음달 장날	2
상일 인터체인지에서 대전 인터체인지까지 가스충전소가 있는 휴게소는 몇 군데지	상일 인터체인지에서 대전 인터체인지까지 가스충전소 휴게소 수	2
증권시장에서 지난 옵션 가격을 행사가 별로 알 수 있을까 	증권시장 행사가 별 지난 옵션 가격	2
이 카드 은행에서 발급받을 수 있어	이 카드 은행 발급 여부	0
코스닥에 등록하는 데 필요한 게 뭐가 있을까	코스닥 등록 필요한 것	2
침대칸이 있을까	침대칸 여부	0
내가 얼마의 주식을 보유해야 그 회사 경영에 참여할 수 있지	회사 경영 참여 위한 보유 주식	2
불국사 가는 길 보여	불국사 가는 길 보이는지	0
학교에서 오늘 뭐 배웠더라	학교에서 오늘 배운 것	2
예매는 전화로는 불가능 해	예매 전화 가능 여부	0
더운 거랑 추운것 중에 어떤 게 좋아요	더운 거랑 추운 것 중 좋은 것	1
수시가 나을까 정시가 나을까	수시 정시 중 나은 것	1
사업상 바쁜 일은 다 마무리 됐어	사업상 바쁜 일 다 마무리 됐는지	0
오늘 모임에 참석할 건가요	오늘 모임 참석 여부	0
이번 컴퓨터 특강 때 무슨 프로그램 배우는지 혹시 알아 	이번 컴퓨터 특강 때 배우는 프로그램	2
혹시 어떡하는 지 알아 	방법	2
이번 달 미팅이 누구와 있나	이번 달 미팅 상대	2
지금 강남대로 교통흐름이 어떻지	지금 강남대로 교통흐름	2
기말고사 시험 범위까지 다 나갈 수 있을까	기말고사 시험 범위까지 다 나갈 수 있을지	0
오늘 경기 비와서 취소 됐니 	오늘 경기 취소 여부	0
벌금 납부기간이 언제까지지	벌금 납부 기한	2
유월은 봄이야 여름이야 잘 모르겠어	유월 봄인지 여름인지	0
울산 무거동에 쌈밥 맛있게 하는 집 있나	울산 무거동 쌈밥 맛있게 하는 집	2
결혼을 앞두고 있는데 어떤 금융상품이 괜찮을까요	결혼 추천 금융상품	2
대학원 수업은 발표 위주로 진행 돼	대학원 수업 발표 위주로 진행되는지	0
부산에서 제일 안 아프게 치료하는 치과는 어디니	부산에서 제일 안 아프게 치료하는 치과	2
왜 우리는 무슨 일이 있어도 학교에 가는 걸까 	학교 가는 이유	2
친구 은화와의 생일이 언제인데	은하 생일	2
작년에 돈 번 걸로 사업 확장할거야	작년에 돈 번 걸로 사업 확장할지	0
현재 전국의 풍량은 어떤데	현재 전국 풍량	2
오늘 날씨 많이 풀렸어	오늘 날씨 많이 풀렸는지	0
해외 유학은 돈이 많이 들어	해외 유학 돈이 많이 드는지	0
교회에 가고 있어	교회에 가고 있는지	0
신용카드 언제까지 사용 가능해	신용카드 사용 기한	2
오늘 유가가 어찌되니	오늘 유가	2
정통부 사 세대 이동 통신개발과 관련된 소식 뭐래	정통부 사 세대 이동 통신개발과 관련된 소식	2
현관 자물쇠가 잠겨 있니	현관 자물쇠 잠겨 있는지	0
엉치뼈가 자꾸 아파 와 	엉치뼈가 자꾸 아픈지	0
남자들은 왜 시간약속을 못 지키나요 	남자들 시간약속 못 지키는 이유	2
오늘 새 편지 중 정미가 보낸 메일을 찾니	오늘 새 편지 중 정미가 보낸 메일	2
양재 인터체인지 상황은 어떻데니	양재 인터체인지 상황	2
기획 영업팀의 성격과 하는일이 궁금해요	기획 영업팀 성격 업무	2
현재 경부 고속도로의 날씨는 어떻게 되	현재 경부 고속도로 날씨	2
신문에 나오는 주식시세표 어떻게 보는 거야	신문 주식시세표 보는 방법	2
걔 신용불량자가 됐데	걔 신용불량자 됐는지	0
비행기 표는 예약 해 뒀니	비행기 표 예약 여부	0
요즘 은행에 왜 그렇게 핸드폰 매매가 많니 	요즘 은행 핸드폰 매매 많은 이유	2
괜찮은 놈 이야 사귈래	사귈지	0
그 은행에 대해서 자세히 알고 있어	그 은행 정보	2
시흥에서 대부도 쪽으로 어떻게 빠지는지 혹시 아냐 	시흥에서 대부도 쪽 빠지는 방법	2
남산공원 부근 편의점 어디에 있니	남산공원 부근 편의점 위치	2
오늘 저녁 기온이 어떻게 되지	오늘 저녁 기온	2
오늘 기온이 몇 도나 되	오늘 기온	2
아 벌써 유월이야 이번 달 안에 볼 수 있을까	이번 달 볼 수 있을지	0
뭐 해줄꺼야	해줄 것	2
컴퓨터 고치러 몇 시에 오실 거예요	컴퓨터 고치러 올 시각	2
증권 시장에서 장외 시장이란 게 뭔 줄 아니	장외 시장 의미	2
호창아 돈 많이 벌었어 	돈 많이 벌었는지	0
월급 받는 날이 얼마나 남았지	월급 받는 날까지 남은 기간	2
빨래는 추운 날씨와 더운 날씨 중 어느 때 더 잘 마를까	추운 날씨 더운 날씨 중 빨래 더 잘 마를 때	1
일정한 소득이 있어야 신용카드를 만들 수 있어	일정한 소득이 있어야 신용카드 만들 수 있는지	0
뭐 먹을까	먹을 것	2
오늘 선약이 있데	오늘 선약 여부	0
거의 다 왔어	거의 다 왔는지	0
야간자율학습 더 해야 해	야간자율학습 더 해야 하는지	0
잘 지내	잘 지내는지	0
개인 계좌조회를 할수 있나요 	개인 계좌조회 가능 여부	0
차익 매물이 쏟아질 가능성이 많다는데 할 거예요	차익 매물 쏟아질 가능성이 많다는데 할지	0
지금 우리는 어디에 있어요	지금 우리 위치	2
케이티엑스 역방향인데 멀미 나지 않겠어 	역방향 멀미 괜찮을지	0
이번 달부터 요가 한다고 하던데 어느 요가원이야 	요가원	2
오늘 방화 관련 기사는	오늘 방화 관련 기사	2
아웃백 싸게 먹을려면 뭐 먹어야해	아웃백 저렴 메뉴	2
주식과 펀드 차이를 모르겠어	주식 펀드 차이	2
오늘 일곱시에 누구 만나기로 했지	오늘 일곱시 만나기로 한 사람	2
지금 교통이 혼잡해	지금 교통 혼잡한지	0
행복해요	행복한지	0
세탁기 불림 코스 선택하는가	세탁기 불림 코스 선택 여부	0
정말 보고 싶을까	정말 보고 싶을지	0
고속도로와 국도 중 어느 것이 좋겠니	고속도로 국도 중 좋은 곳	1
구월의 부산 지방의 전반적인 기상 정망은 어때	구월 부산 지방 전반적 기상 정망	2
설마 정말이야	정말인지	2
아직 일하냐	아직 일하는지	0
경부 고속도로 상행선 정체는 여전하니	경부 고속도로 상행선 정체 여부	0
거기 눈오니	눈오는지	0
경부 고속도로 노면이 결빙된 구간 어떠니	경부 고속도로 노면 결빙 구간	2
오늘의 주가는 어떨지	오늘의 주가	2
제품의 문제점이 무엇입니까	제품의 문제점	2
평균 수명이 늘어나서 교육 기간이 길어지는 걸까 	교육 기간 길어지는 이유	2
이번 주말에 성당 가서 세례 받아	이번 주말 성당 가서 세례 받는지	0
이번에 곗돈 타면 무엇을 할 거야 	곗돈 타면 할 것	2
해운대에서 연인들이 제일 많이 찾는 커피숍은 어디니	해운대 연인들 많이 찾는 커피숍	2
홍도는 뭘로 유명하니	홍도 유명한 것	2
다큐멘터리로 제작할거야	다큐멘터리 제작 여부	0
세계 여행을 할 때 나라들의 인사법을 알아야 하나 	세계여행 할 때 나라들 인사법 알아야 하는지	0
아직 외국인들의 투자 한도액이 확대되지는 않았어	외국인 투자 한도액 확대 여부	0
논문 발표일이 언제야	논문 발표일	2
이월 육일이 백화점 세일 첫날이야	이월 육일 백화점 세일 첫날인지	0
갑상선 부은 것은 괜찮아	갑상선 부은 것 괜찮은지	0
이번 휴가 때 해외 여행 갈까 	이번 휴가 때 해외여행 갈지	0
앞으로 과연 더 오를 수 있을지 모르겠다	앞으로 더 오를 수 있을지	0
그 렌즈 두 개 짜리는 파노라마인가요	렌즈 두 개 짜리 파노라마인지	0
어디 있니 로비야	지금 있는 위치	2
사 인실 있을까	사 인실 여부	0
어젯밤 송신 내용 중 세시 에서 다섯시 사이에 확인된 이메일은	어젯밤 송신 내용 중 세시 에서 다섯시 사이에 확인된 이메일	2
주식부자와 부동산 부자와 어떤 차이가 있나요	주식부자 부동산 부자 차이	2
그 사람한테는 얻어 먹기 싫지	그 사람한테 얻어 먹기 싫은지	0
미국이나 유럽의 이율은 어떨까	미국 유럽 이율	2
내일부터 설날 연휴 기차표 예매 시작이래 	내일부터 설날 연휴 기차표 예매 시작인지	0
비가 와서 해수욕 금지래	해수욕 금지 여부	0
해외 지사 진출 방향은 어떻게 됩니까	해외 지사 진출 방향	2
부담스러울 까봐 연락 안 했어	부담스러울까봐 연락 안 했는지	0
괜찮아	괜찮은지	0
부산의 외삼촌은 잘 지내셔	부산 외삼촌 잘 지내시는지	0
그냥 그래	그냥 그런지	0
야유회 하는데 비 오면 어쩌지 	야유회 비 대책	2
많이 아파	많이 아픈지	0
오늘 메뉴가 뭐야	오늘 메뉴	2
몇 시간 정도 늦어요	늦는 정도	2
시외버스터미널 가서 고속버스타고 갈 거야	시외버스터미널 가서 고속버스타고 갈지	0
교통문화 선진국의 시민들은 교통법규를 잘 지킬까	교통문화 선진국 교통법규 잘 지킬지	0
음식을 가려 먹으면 다른 영양분이 부족해져	음식 가려 먹으면 다른 영양분 부족해지는지	0
서울대 주변 나이트 클럽 어디니	서울대 주변 나이트 클럽	2
오늘자 동아일보에 취업공고 났어	오늘자 동아일보 취업공고 났는지	0
홍 과장님 송별회에 뭐 특별한 거 준비 할 게 있을까 	송별회 특별한 준비물	2
내가 그 약속 안 지키면 곤란해져 	내가 그 약속 안 지키면 곤란해지는지	0
그래도 수영보단 그 운동이 더 좋아	수영보단 그 운동이 더 좋은지	0
명절 잘 지내	명절 잘 지내는지	0
오늘 저녁에 쇼핑 갈까 술 한 잔 할까	오늘 저녁 쇼핑갈지 술 한 잔 할지	1
건강보험료를 그대로 다 내야 하나요 	건강보험료 그대로 다 내야 하는지	0
그 동안 뭐했길래 연락도 없었어	근황	2
군자역 근처의 농협은 어디일까	군자역 근처 농협 위치	2
내일 저녁 어떠세요	내일 저녁 어떤지	0
지금 점심 먹으려고 예약한 가게에 도착했는데 아직 멀었니 	오래 걸리는지	0
폭우를 막기 위한 방법은 없을까 	폭우 막는 방법	2
한반도의 위성사진 보여	한반도 위성사진 보이는지	0
이승환 콘서트 요금 카드로 결제했어	이승환 콘서트 요금 카드 결제했는지	0
서울 구리 간 국도 상황이 어떻지	서울 구리 간 국도 상황	2
단양 인터체인지에서 북안동 인터체인지까지 흐름은 좋은가	단양 인터체인지에서 북안동 인터체인지까지 흐름	2
비용에 대해서는 업무와 관련된 비용만 지급돼	업무 관련 비용만 지급되는지	0
그래서 휘청거리는 거야 	그래서 휘청거리는지	0
경부 고속도로 내 소통 원활한 구간은 어디래	경부 고속도로 내 소통 원활 구간	2
적금을 들려고 하는데 일 년이 좋을까 이 년이 좋을까	적금 일 년 이년 중 좋은 것	1
천호동에서 상일 인터체인지까지 흐름이 어떻지	천호동에서 상일 인터체인지까지 흐름	2
터미널까지 가장 빠른 대중교통수단이 뭐야 	터미널까지 가장 빠른 대중교통수단	2
내일 스승의 날인데 교문에서 만나는 거야	내일 교문에서 만나는지	0
한미카드에서 몇 통의 이메일이 왔지	한미카드에서 온 이메일 수	2
제 사이즈로 있나요	제 사이즈 있는지	0
거기로 송금할까 	거기로 송금할지	0
내후년 대선에 관한 새로운 소식 나왔니	내후년 대선 새로운 소식 나왔는지	0
이율 가장 높은 기관이 어디예요	이율 가장 높은 기관	2
요즘 야위어 보이시네요 아프세요 	아픈지	0
관광 버스가 있나요	관광버스 여부	0
그 아이와의 약속은 못 지켜	그 아이 약속 못 지키는지	0
한식이랑 중식 중에 뭐 먹을까	한식 중식 중 먹을 것	1
오늘 발표 준비는 잘해왔어	오늘 발표 준비 여부	0
다른 사람에게 은행 명의를 대체 왜 빌려준 건데 	은행 명의 빌려준 이유	2
강촌 가는데 버스로 갈까 기차로 갈까	강촌 가는데 버스로 갈지 기차로 갈지	1
언어교육원에서 이루어지는 영어 회화 강의는 들을 만 하니	언어교육원 영어 회화 강의 들을 만한지	0
너 요가 해서 효과 좀 봤냐 	요가 효과 여부	0
잘 됐네요 오늘 오후 네 시쯤은 어떠세요 저는 요시다라고 해요 그쪽 사무실까지 어떻게 가는지 좀 가르쳐주셨으면 하는데요	오늘 오후 네 시 어떤지	0
오늘 청주지역의 구름양이 어떻게 되지	오늘 청주지역 구름양	2
십 인실로 변경할래	십 인실로 변경할지	0
함부로 뛰어들진 못하죠	함부로 뛰어들진 못하는지	0
용산 주변 휴대폰 대리점은 어디냐	용산 주변 휴대폰 대리점 위치	2
진영이 교육보험 들었어	진영이 교육보험 들었는지	0
내가 오늘 현철이에게 보낸 메일 제목이 뭐니	내가 오늘 현철이에게 보낸 메일 제목	2
혜진이한테 얘기 들었어	혜진이한테 얘기 들었는지	0
오늘 포관 지하 컴퓨터실 문 일찍 닫아	오늘 포관 지하 컴퓨터실 문 일찍 닫는지	0
부산 가는 비행기 하루에 몇 회 운행이야	부산 가는 비행기 하루 운행 회수	2
누나 저 어제 서울 올라왔어요 어떻게 지내세요 	근황	2
요즘 어떠세요	근황	2
어제 너 과음했는데 괜찮아 	과음 후 괜찮은지	0
과외가 나을까 학원이 나을까	과외 학원 중 나은 것	1
마누라가 보낸 이메일이 몇 개나 있지	마누라가 보낸 이메일 수	2
가뭄이라던데 너희 시골집 괜찮아	시골집 괜찮은지	0
여기로 올 수 없지	여기로 올 수 있는지	0
요즘 숙모 댁의 식구들은 잘 지내고 있습니까 	숙모 댁 식구들 잘 지내는지	0
추석 때 뭐 타고 가실 거에요	추석 때 타고 갈 것	2
약은 먹었어	약먹었는지	0
어젯밤 온 메일 중 첨부 파일 든 메일 얼마나 될까	어젯밤 온 메일 중 첨부 파일 든 메일 수	2
영어 단어 오십 개뿐이 못 외웠어 너는	외운 단어 수	2
틀렸어	틀렸는지	0
니스 카니발 여행 예약해	니스 카니발 여행 예약하는지	0
양재동에 위치한 이마트는 어떻게 간데	양재동 위치 이마트 가는 방법	2
지금 서귀포에 안개 주의보가 발령됐니	서귀포 안개 주의보 발령 여부	0
매주 수요일마다 모임을 가지는 거야	매주 수요일마다 모임 가지는지	0
서울에 있는 가볼만 한 박물관 정보가	서울 가볼만 한 박물관	2
귀찮아	귀찮은지	0
내년 구정연휴가 며칠이나 된데	내년 구정연휴 기간	2
삐졌어	삐졌는지	0
올 봄 날씨는 어때	올 봄 날씨	2
대학로 가려면 버스랑 지하철 중에 뭐가 더 나아	대학로 가려면 버스 지하철 중 나은 것	1
모레 비가 올까 안올까	모레 비 올지	0
이 열차는 급행입니까 완행입니까	이 열차 급행인지 완행인지	1
전부 외웠어	전부 외웠는지	0
내일 신촌에서 보는 건 취소됐어	내일 신촌에서 보는 건 취소됐는지	0
케이블카도 교통 수단이라고 할 수 있을까 	케이블카 교통 수단 여부	0
시험 며칠 전부터 공부해야 할까	시험 공부할 기간	2
대구 은행은 대출 금리가 어떻게 되니	대구 은행 대출 금리	2
학원 다니는 게 나을까 과외 나을까 	학원 과외 중 나은 것	1
경부 고속도로에 노면이 결빙된 구간 얼마나 돼	경부 고속도로 노면 결빙 구간 정도	2
채권가격과 채권 금리가 반비례하는 이유는 뭐야	채권가격 채권 금리 반비례 이유	2
혹시 국문학사 시험 범위 알고 있어	국문학사 시험 범위	2
수신 카드 쓰면 컴퓨터 속도가 느려진대요	수신 카드 쓰면 컴퓨터 속도가 느려지는지	0
지난달에 미용실에 갔던 날은 언제지	지난달 미용실 갔던 날	2
부산에서 분위기가 제일 좋은 바는	부산 분위기 제일 좋은 바	2
지금 나비효과 보고 나오는 길이야	지금 나비효과 보고 나오는 길인지	0
생계형 적금은 어떻게 가입하는 거야 	생계형 적금 가입 방법	2
에스유브이와 알브이 중 어느 것이 더 경제적일까 	에스유브이 알브이 중 경제적인 것	1
지연이 요번 기말고사에 평균 오점이나 떨어졌대	지연이 요번 기말고사 평균 오점 떨어졌는지	0
마누라 생일이 언제지	마누라 생일	2
올해 추석 연휴는 며칠부터이지	올해 추석 연휴 시작 날짜	2
주주들의 마음을 잡기 위해 어떻게 해야 될까 	주주들 마음 잡기 위해 할 것	2
취약과목은 어떻게 해야할지 모르겠어	취약과목 대비법	2
사내전산망이 왜 고장났지	사내전산망 고장 이유	2
부산 시내 정체구간은 얼마나 되니	부산 시내 정체구간 수	2
신체검사할 때 뭐뭐 하는데	신체검사할 때 하는 것	2
너 학기말 시험이 언제인지 아니	학기말 시험 날짜	2
일하는 엄마도 수유가 가능한가	일하는 엄마 수유 가능 여부	0
주식은 운일까 실력일까	주식 운일지 실력일지	1
첫 만남에서는 좀 튕겨	첫 만남에서는 좀 튕길지	0
최윤영 요가 다운 받아서 구웠는데 이거 어떻게 봐야 해	최윤영 요가 보는 방법	2
어제 과음하더니 오늘은 기분이 괜찮아 	기분 괜찮은지	0
판테온 포함인가요	판테온 포함 여부	0
대출을 할 때 주부인 나는 배우자의 것으로 서류를 준비해도 돼	주부 대출 배우자 서류 준비 가능 여부	0
그녀와의 약속 오늘 아니었어	그녀와의 약속 오늘 아닌지	0
육인용 테이블 있어요	육인용 테이블 여부	0
이번 태풍 때문에 피해 많던데 너네 집은 괜찮은거야	집 괜찮은지	0
오늘 저녁에 쇼핑 갈까 술 한 잔 할까 	오늘 저녁 쇼핑할지 술 한 잔 할지	1
현관에 방문한 사람이 있니	현관 방문한 사람 있는지	0
오늘 과장님하고 스쿼시 치는 날이야	오늘 과장님하고 스쿼시 치는지	0
부부싸움은 안 하고 사는 거지	부부싸움 안 하는지	0
규칙적으로 운동할 자신은 있는 거야 	규칙적 운동 자신 있는지	0
우리 눈 내리던 날 했던 첫 키스 생각나	눈 내리던 날 첫 키스 생각나는지	0
저한테 저녁 사주신다는 약속 아직 유효한 거죠	저녁 사주는지	0
경부 고속도로 노면이 결빙된 구간 어딘데	경부 고속도로 노면 결빙 구간 위치	2
교실에 몇 명이나 있지	교실 인원 수	2
엘지텔레콤과 케이티에프가 합병됐데	엘지텔레콤 케이티에프 합병 여부	0
오늘 들어올 돈이 왜 아직 안 들어오는 걸까	돈이 안 들어오는 이유	2
현재 태풍의 진행 상황은 어떻지	현재 태풍 진행 상황	2
허리가 아프다니 왜 무슨 일 있었어 	무슨 일 있었는지	0
누구 일본말 할 줄 아는 분 계세요	일본말 가능 여부	0
동래방향에 무인카메라 위치	동래방향 무인카메라 위치	2
길 일동 우체국은 어디일까	길 일동 우체국 위치	2
혹시 국문학사 시험 범위 알고 있어	국문학사 시험 범위	2
거래처 업무 아직 안 끝났나요	거래처 업무 끝났는지	0
우리 부모님 결혼기념일이 언제지	우리 부모님 결혼기념일	2
내일 전주의 세차지수는	내일 전주 세차지수	2
돈 여유 있으면 내가 잘 아는 주식에 투자 한 번 해볼래 	주식투자 해볼지	0
카드 연체대금 납부일이 며칠이야	카드 연체대금 납부일	2
오늘 이 자리에 나오는 게 확실하긴 한 걸까	오늘 이 자리에 나오는 게 확실한지	0
선배님 외지에서도 건강하게 잘 지내시죠	잘 지내는지	0
이자는 년 몇 퍼센트야 	년 이자율	2
앞으로의 주간 전망은 어떻게 될까요	주간 전망	2
토익 육십점 넘어야 졸업 가능해	토익 육십점 넘어야 졸업 가능한지	0
서울대 인근 당구장 어딘데	서울대 인근 당구장 위치	2
그 기업의 시장 점유율은 어느 정도야 	그 기업 시장 점유율	2
추석이 며칠이지	추석 날짜	2
올 여름 예상 강수량 얼마나 될까	올 여름 예상 강수량	2
중부 고속도로 교통량이 어떠니	중부 고속도로 교통량	2
너 주식한다면서 여윳돈은 좀 있는 거야 	여윳돈 여부	0
주식을 보유하고 있으면 주식배당금을 지급 받는 거야	주식 보유하면 주식배당금 지급 받는지	0
상규 선배 재작년에 삼성증권 입사하지 않았냐	상규 재작년 삼성증권 입사 여부	0
날이 안 좋아	날이 안 좋은지	0
고향 뭐 타고 내려갈 거야	고향 타고 갈 것	2
보통 은행 영업시간이 몇 시까지예요	은행 영업 종료 시각	2
여기는 처음이신가요	여기 처음인지	0
해외 은행으로 송금할 때 이체 이자가 높지 않을까  	해외 은행 송금 이체 이자 높은지	0
김치찌게 먹을까	김치찌개 먹을지	0
같이 저녁 먹을까	같이 저녁 먹을지	0
같이 연극본지 꽤 오래 된 것 같은데 이번 주는 연극을 볼까 	이번 주 연극 볼지	0
이제 내일이면 물리치료 끝나	내일이면 물리치료 끝나는지	0
이렇게 열심히 운동해서 무슨 대회라도 나가려고 하는 거야 	대회 나가는지	2
요즘 코스닥 시장 상황은 어때 	요즘 코스닥 시장 상황	2
나 오늘 렌즈 사러 가려고 하는데 일회용이 좋을까 영구적인 것 사는 게 좋을까	렌즈 일회용 영구적인 것 중 좋은 것	1
올 크리스마스에 눈이 올까	올 크리스마스 눈 올지	0
오늘 큰 아빠 퇴원은 잘 하셨어요	큰 아빠 퇴원 잘 하셨는지	0
우리 마누라 생일이 언제지	우리 마누라 생일	2
현재 중부 하행선 교통이 통제되는 구간은 어떠니	현재 중부 하행선 교통 통제 구간 상황	2
한국 대표팀 축구 기사 있어	한국 대표팀 축구 기사	2
요새는 녹차 호떡이 유행하던데 그걸로 장사나 해볼까	녹차 호떡 장사 어떨지	0
어제 롯데 선수들의 게임 기사는 없을까	어제 롯데 선수들 게임 기사	2
박사 논문 마감일이 언제일까	박사 논문 마감일	2
갑갑할 때는 교외로 친구들과 드라이브를 가	갑갑할 때 교외로 친구들과 드라이브 가는지	0
현재 전국의 풍량은 어떤가	현재 전국의 풍량	2
하나도 없어	하나도 없는지	0
거기서 유턴 되는지 모르겠네	유턴 가능 여부	0
광안리에서 연인들이 제일 많이 가는 레스토랑 어떻게 가냐	광안리 연인들 많이 가는 레스토랑 가는 방법	2
이번에도 승진에서 밀렸는데 대체 승진의 요건이 뭐야 	승진 요건	2
현민이는 어젯밤 몇 통을 보냈지	현민이 어젯밤 보낸 수	2
방카슈랑스란	방카슈랑스 의미	2
컴퓨터로도 주가 확인할 수 있어	컴퓨터 주가 확인 가능 여부	0
추워서 야외 행사는 취소 됐어	야외 행사 취소 여부	0
첫 월급을 받았는데 뭐 필요한 거 있어 	필요한 것	2
항공 우편이요	항공 우편인지	0
이번 달까지 부으면 끝이야	이번 달까지 부으면 끝인지	0
차들이 안 움직여 	차들이 안 움직이는지	0
더위 먹었냐	더위 먹었는지	0
핸드볼 국가대표 감독에 관한 기사가 있어	핸드볼 국가대표 감독 기사	2
넌 지금 어느 역 지나고 있어	지금 지나는 역	2
이 회사 주식을 팔아야 할까 아님 가지고 있어야 할까	이 회사 주식 팔지 가지고 있을지	1
서울대 앞 리치골드는 어디에 있니	서울대 앞 리치골드 위치	2
오늘 온 편지 중 첨부 파일이 든 메일은 얼마나 되냐	오늘 온 편지 중 첨부 파일이 든 메일 수	2
환전은 외환은행 말고 아무 은행에서라도 할 수 있는 거지	환전 아무 은행 가능 여부	0
여의도에서 불꽃축제 했어	여의도 불꽃축제 했는지	0
체크 인 언제 하니	체크 인 시각	2
영어학원에 다닌 효과가 있는 것 같니 	영어학원 효과 여부	0
서울역 근처 많이 가는 노래방은 어딘데	서울역 근처 많이 가는 노래방	2
어떤 방이 있니	방 종류	2
오늘 몇 시쯤 퇴근할 것 같아	오늘 퇴근 시각	2
지금 뭐 하고 있지	지금 뭐 하고 있는지	0
몇 시에	시각	2
주식회사라는 말은 전부다 상장기업임을 의미합니까	주식회사 상장기업 의미 여부	0
주식으로 번 돈은 쉽게 쓴다는데 도대체 왜 그런거야	주식으로 번 돈 쉽게 쓰는 이유	2
시내 가는 가장 빠른 방법은 뭘까	시내 가는 가장 빠른 방법	2
오늘 강수량이 얼마나 되지	오늘 강수량	2
짜장면 먹고 싶지 	짜장면 먹고 싶은지	0
우리학교 아침 조례시간이 언제지	우리학교 아침 조례시간	2
보험이랑 대출은 작년 십이월 이후로 실효된 상태야 	보험 대출 작년 십이월 이후 실효 상태인지	0
시험 날짜랑 장소 발표 됐어	시험 날짜 장소 발표 여부	0
부산 시내 정체구간 얼마나 되니	부산 시내 정체구간 정도	2
상위권 대학은 어려울 것 같아	상위권 대학 어려울지	0
대구 몇 시에 도착일까	대구 도착 시각	2
굿모닝증권과 신한증권 중 어디가 나을까	굿모님증권 신한증권 중 나은 것	1
아직 일하냐	아직 일하는지	2
등굣길에는 자전거를 타고 다녀요	등굣길 자전거 타고 다니는지	0
서울에서 제일 안 아프게 치료하는 치과는 어떻게 가니	서울 안 아프게 치료하는 치과 가는 방법	2
누구 일본말 할 줄 아는 분 계세요	일본말 가능 여부	0
팔팔 고속도로에 공사하는 곳 있나	팔팔 고속도로 공사하는 곳 여부	0
올 겨울 부산에 눈 올 확률은	올 겨울 부산 눈 확률	2
요즘 추운데 잘 지내냐	잘 지내는지	0
이제서야 접영 시작했잖아 그런데 왜 안 되는지 모르겠어	접영 안되는 이유	2
어제 과음했지만 네가 부르면 가야지 어디서 만날까 	만나는 장소	2
주요 도시의 강수 분포도 어떻데	주요 도시 강수 분포도	2
지금 퇴근	지금 퇴근하는지	0
옛날에 우리 같이 수업 빠지고 놀러 다니던 일 기억나니	옛날 기억나는지	0
구월달 부산 지방의 전반적인 기상 전망은 어떻데	구월달 부산 지방 전반적 기상 전망	2
부산시 진입로 지체구간은 어딘가	부산시 진입로 지체구간 위치	2
음료수 포함인가요	음료수 포함 여부	0
부산시 소재 영화관 어디야	부산시 소재 영화관 위치	2
교수님 연구실이 몇 호실이야	교수님 연구실 호실	2
농협 공제 종류가 몇 가지나 되나요	농협 공제 종류	2
괜찮으세요	괜찮은지	0
부산 시내 지체구간은 얼마나 되지	부산 시내 지체구간 정도	2
울산 정자 주위의 펜션은	울산 정자 주위 펜션	2
대출을 위한 제출서류가 필요합니까	대출 제출서류 필요 여부	0
팩스를 어디서 보낼 수 있을까요	팩스 보내는 곳	2
제주에서 부산까지 이용할 수 있는 배편이	제주에서 부산까지 배편	2
내일 부산 지역 일몰 출몰 시간이 어떻게 되니	내일 부산 지역 일몰 출몰 시간	2
육삼빌딩 주변 호프집 어떻게 갈까	육삼빌딩 주변 호프집 가는 방법	2
모의주식과 실제주식의 주식가격은 같은 거야	모의주식 실제주식 가격 같은지	0
지역별 전운량이 어떻데니	지역별 전운량	2
다음주 수요일로 예약했어요	다음주 수요일 예약했는지	0
요즘 홈페이지에 소식도 잘 안올리고 뭐하면서 살고 있어 	근황	2
차라리 외근이 나아	차라리 외근이 나은지	0
우리 조는 다음 주에 발표야	우리 조 다음 주 발표인지	0
진행요원 오백 명 다 채워졌나 	진행요원 오백 명 다 채워졌는지	0
음주 운전과 무면허 중 어떤 게 더 나쁜 걸까	음주운전 무면허 중 나쁜 것	1
지금 바뻐	지금 바쁜지	0
과외가 나을까 아님 학원을 끊을까	과외가 나을지 학원을 끊을지	1
단전호흡이 좋을까 요가가 좋을까 고민 중이랍니다	단전호흡 요가 중 좋은 것	1
요즘 씨엠에이 금리 몇 퍼센트래	요즘 씨엠에이 금리 퍼센트	2
남산공원 부근의 일식집은 어떻게 찾아가지	남산공원 부근 일식집 찾아가는 방법	2
오월 칠일이 너 생일 맞지	오월 칠일 생일 맞는지	0
송정 부근 주차장은 어디냐	송정 부근 주차장 위치	2
제목에 생일축하라는 말이 있는 메일은 몇 개지	제목 생일축하라는 말이 있는 메일 수	2
지금 회의중	지금 회의중인지	0
증권 할 때 주로 어떤 지표나 정보를 눈여겨봐야 하는지 아니	증권 할 때 눈여겨봐야 할 지표 정보	2
이번에 은행이 망했다는데 내 예금은 괜찮겠지 	예금 괜찮을지	0
스쿼시 하니까 어때 재밌나 나도 해볼까 	스쿼시 재밌는지	0
어머 얘 보고 싶다 잘 지내지	근황	2
고모님 회갑 잔치가 언제지	고모님 회갑 잔치 날짜	2
폰뱅킹과 인터넷뱅킹 중에 어느 게 더 나아	폰뱅킹 인터넷뱅킹 중 나은 것	1
주요 도시의 강수 분포도는 얼마지	주요 도시 강수 분포도	2
버스가 빠를까 지하철이 빠를까	버스 지하철 중 빠른 것	1
지금 운전중	지금 운전중인지	0
동대문에서 제일 싼 술집은 어디니	동대문 제일 싼 술집	2
나 해외여행 가는데 면세점 갈 거야 뭐 필요해	면세점 필요한 것	2
남대문에서 제일 싼 술집은 어디냐	남대문 제일 싼 술집	2
홍제 램프 부근은 시시티브이로 찍은 정보도 볼 수 있니	홍제 램프 부근 시시티비 찍은 정보 볼 수 있는지	0
숙제 다 했어	숙제 다 했는지	0
병원에는 무슨 일로 입원하셨어요	병원 입원 이유	2
과연 다른 나라의 대중 교통보다 우리나라가 더 좋을까  	우리나라 대중 교통 다른 나라보다 좋을지	0
저번 주에 무슨 기념일이 있었지	저번 주 기념일	2
십 대 건강식품과 관련된 기사는	십 대 건강식품 관련 기사	2
냉장실 온도 약 하지	냉장실 온도 약한지	0
줄넘기 하면 키 큰다는데 난 왜 안 크지	키 안 크는 이유	2
아침 내내 뛰어다녔어요	아침 내내 뛰어다녔는지	0
소이 영어학원비 언제까지 내지	소이 영어학원비 납부 기한	2
부산의 오늘 체감온도는 얼마지	부산 오늘 체감온도	2
거기만 조금 뚫리면 괜찮아	거기만 조금 뚫리면 괜찮은지	0
이번엔 복권 당첨 됐어	복권 당첨 여부	0
어젯밤 온 메일 중 첨부 파일 든 메일은 몇 통이나 된데	어젯밤 온 메일 중 첨부 파일 든 메일 수	2
오빠 엄마 아빠는 잘 계시고 할머니는 편찮으신데 없으시지	할머니 괜찮으신지	0
모기 물린 데 물 파스를 바르는 게 진짜 효과가 있을까	모기 물파스 효과 여부	0
지금 경부 고속도로는 어떻지	지금 경부 고속도로 상황	2
신수 향수병 생기면 어떻게 하냐	향수병 대책	2
요즘 건강은 어떠세요	요즘 건강 어떤지	2
골프장은 어디에요	골프장 위치	2
자산운용협회가 믿을 만 한가	자산운용협회가 믿을 만 한지	0
앓아 누웠어	앓아 누웠는지	0
기말고사 시험범위 알어	기말고사 시험범위	2
서울 종로구 대형 서점은 어디일까	서울 종로구 대형 서점	2
어젯밤에 꽤 춥더라 잠은 잘 잤니 	어젯밤 잘 잤는지	0
스노보드 위험하진 않아	스노보드 위험 여부	0
사고 지점만 지나고 나면 곧 괜찮아지겠지	사고 지점 지나면 괜찮을지	0
주식 투자를 할까 아니면 땅을 좀 살까	주식 투자할지 땅 살지	1
서울 종로구 대형 서점은	서울 종로구 대형 서점	2
아파트 청약 걸어놨데 	아파트 청약 걸어놨는지	0
케이티엑스 열차표 예매에서 제일 할인이 많이되는 시간은 언제니	케이티엑스 열차표 예매에서 제일 할인 많이 되는 시간	0
삼성전자가 유망하다는데 주식을 살까	삼성전자 주식 살지	0
이번 달에 선연이를 만날 날이 무슨 요일이었지	이번 달 선연이 만날 날 	2
음 고속도로랑 국도 중에 어느 쪽으로 가는 게 좋을까	고속도로 국도중 갈 곳	1
점심은 샌드위치로 할 거야	점심 샌드위치로 할지	0
그 회사 주주총회 열었다는데 주가에 영향 미칠까	회사 주주총회 주가 영향 미칠지	0
놀이 공원 가고 싶어	놀이 공원 가고 싶은지	0
오늘 발표 준비는 잘해왔어	오늘 발표 준비 잘해왔는지	0
대림산업의 어제 주가급등의 이유는 뭡니까	대림산업 어제 주가급등 이유	2
편도표입니까 왕복표입니까	편도표인지 왕복표인지	1
이 카메라는 보증서 있나요	카메라 보증서 여부	0
결혼식 식장도 예약했어 	결혼식 식장 예약 여부	0
요즘 건강은 어떠세요	건강 괜찮은지	0
비가 오려나	비가 올지	0
전국 주요 도시의 강수 분포도는 어떻지	전국 주요 도시 강수 분포도	2
야 여기서 안양 가려면 몇 번 버스 타야 돼	안양 가는 버스	2
소통이 원활한 구간은 어디니	소통 원활 구간	2
웨딩 촬영 멋지게 잘 했어 보고 싶다 얼마나 예쁜지 	웨딩 촬영 잘 했는지	0
괜찮니	괜찮은지	0
이번에 취직했다던데 어떤 회사야 	이번 취직 회사	2
지금 하남시의 오존지수는 얼마지	지금 하남시 오존지수	2
오빠 결혼식은 언제지	오빠 결혼식 날짜	2
스쿼시랑 라켓볼이랑 어느 쪽이 더 어렵니	스쿼시랑 라켓볼 중 더 어려운 쪽	2
연계은행 계좌는 왜 필요한지	연계은행 계좌 필요 이유	2
경부 고속도로 노면이 결빙된 구간은 어딘데	경부 고속도로 노면 결빙 구간 위치	2
수표는 수수료 없이 그냥 현금으로 바꿔주나요 	수표 수수료 없이 현금 바꿔주는지	0
야간 비행 예약해	야간 비행 예약할지	0
정체 구간이 몇 곳이나 되지	정체 구간 수	2
대전행 고속철 두 장 예약해	대전행 고속철 두 장 예약하는지	0
뮤지컬 티켓 구해주기로 한 거 대신에 밥을 사면 안 될까 	밥 사도 될지	0
현재 황사 주의보 내려진 지역은 얼마나 되냐	현재 황사 주의보 내려진 지역 수	2
돈 없어	돈 없는지	0
이십칠일 서울의 눈 올 확률은 얼마나 되니	이십칠일 서울 눈 올 확률	2
삼성전자에 관한 기사 있나	삼성전자 관한 기사 여부	0
둘째가 언제 출장에서 돌아 오지	둘째 출장 돌아오는 시기	2
올해 수능일이 언제냐	올해 수능일	2
콜오더 서비스 이용하면 수수료 얼마야 	콜오더 서비스 수수료	2
오늘 케이티엑스 서울편 출발 시각은 몇 시니	케이티엑스 서울편 출발 시각	2
심야버스는 몇 시까지 운행하는 지 알아 	심야버스 운행 시간	2
주택 청약은 언제부터 했나요	주택 청약 시작 시기	2
내년 어머니 생신은 무슨요일이야	내년 어머니 생신 요일	2
그래 잘 도착 했어	잘 도착 했는지	0
보건소에도 이빨 때우는 거 하냐	보건소 이빨 때우는지	0
방카슈랑스 시행한 게 작년인가	방카슈랑스 시행 시기	2
강릉에 있는 해수욕장의 온도는 얼마나 되지	강릉 해수욕장 온도	2
라섹보다 라식이 회복이 빨라	라섹보다 라식 회복 빠른지	0
명절 때 내려갈 차표 미리 예매해 뒀어 	명절 때 내려갈 차표 미리 예매해 뒀는지	0
언제 좌석이면 예약할 수 있나요	좌석 예약 가능 시간	2
현금카드가 직불카드의 기능도 해	현금카드 직불카드 기능 여부	0
서울일보 근처의 일식 전문점은	서울일보 근처 일식 전문점	2
김치찌게 괜찮아	김치찌게 괜찮은지	0
막내 소풍가는 날짜가 언제인가	막내 소풍 날짜	2
주식을 팔아 현금으로 쓰려면 어떻게 해야 하는 거야 	주식 팔아 현금 쓰는 방법	2
우리 할머니 제삿날이 언제니	우리 할머니 제삿날	2
일본으로 전화하려면 몇 번을 처음에 눌러야 하나요	일본으로 전화 처음 눌러야 하는 번호	2
이번에 취직했다던데 어떤 회사야 	이번에 취직한 회사	2
주유할 때 포인트제일 많이 쌓이는 카드가 어떤 거야 	주유 포인트 제일 많이 쌓이는 카드	2
밥은 내려가서 먹어요 	밥 내려가서 먹는지	0
부산역 주변 만두 맛있는 중국집은 어디일까	부산역 주변 만두 맛있는 중국집	2
내일 약속있니	내일 약속 여부	0
지금 텔레비전에서 음악 캠프하지 	텔레비전 음악 캠프 하는지	0
대부분의 이유는 무엇입니까	대부분의 이유	2
이번 주말에 과외 몇 시냐	이번 주말 과외 시각	2
압구정동 여자 연예인들이 많이 찾는 성형외과 어디냐	압구정동 여자 연예인들 많이 찾는 성형외과	2
서울 강남구에 양주 파는 곳이 있나	서울 강남구 양주 파는 곳	2
눈 때문에 버스 운행 못한데	버스 운행 못하는지	0
다리 다쳤어	다리 다쳤는지	0
작년보다 올해 수능이 더 어려웠어	작년보다 올해 수능 더 어려운지	0
특실은 비싸니	특실 비싼지	0
영화 끝나면 너무 늦어	영화 끝나면 너무 늦는지	0
비행기는 정시에 도착하나요	비행기 정시에 도착하는지	0
한 시간 후에 은행문 닫는데	한 시간 후 은행문 닫는지	0
유학생송금을 하는 경우에 필요한 서류는 무엇입니까 	유학생송금 필요 서류	2
이렇게 어색할 수가 어떻게 해야 친해지는 거야	친해지는 방법	2
현석이 병원가는 날이 언제지	현석이 병원가는 날	2
내년 종합주가지수 전망은 어떤가요	내년 종합주가지수 전망	2
물 좋아	물 좋은지	0
시험 잘 봤니	시험 잘 봤는지	0
지윤이가 어디서 놀고 있지	지윤이 노는 곳	2
빚내서 하는 거 아니야	빚내서 하는지	0
부산 시내 정체구간은 얼마나 될까	부산 시내 정체구간 정도	2
동래 럭키 아파트 주변 자장면 집 어디야	동래 럭키 아파트 주변 자장면 집 위치	2
이번 과제는 실내서도 촬영 할수 있대 	이번 과제 실내 촬영 가능 여부	0
사랑니 뽑아야 한다면서 괜찮겠어	사랑니 뽑는 것 괜찮은지	0
강동구 소재 호텔 어디야	강동구 소재 호텔 위치	2
이틀 묵으면 얼마야	이틀 숙박 가격	2
시간 얼마나 걸리냐	걸리는 시간	2
요즘 어떠세요	근황	2
언제쯤 시간이 나시는지 하루빨리 뵙고 싶습니다	시간 나는 시기	2
안돼	안되는지	0
항공으로 얼마죠	항공 가격	2
이 약 효과가 확실한 거죠 	약 효과 확실 여부	0
시중 대출의 반도 안 된데	시중 대출 반도 안 되는지	0
해운대에서 연인들이 제일 많이 찾는 커피숍은 어디지	해운대 연인들 제일 많이 찾는 커피숍	2
비행기 몇 시에 예약했나	비행기 예약 시간	2
다큐멘터리 관련해서 인터뷰 하고 싶은데 괜찮을까요 	다큐멘터리 관련 인터뷰 가능 여부	0
아직도 산꼭대기는 눈 쌓여있어	아직 산꼭대기 눈 쌓여있는지	0
날씨가 많이 차요	날씨 많이 찬지	0
십 년만에 찾아오는 더위였대 괜찮았니 	더위 괜찮은지	0
정말 보고 싶어	정말 보고 싶은지	0
학교 포스코 말고 싸고 괜찮은 헬스 장 없어	학교 포스코 말고 싸고 괜찮은 헬스장	2
고속도로로 갈까 국도로 갈까	고속도로 국도 중 갈 곳	1
언제 만날 거야	만나는 시간	2
최근 일 년 동안 주식 동향을 알아볼 만한 사이트 아니	주식 동향 사이트	2
고려대 근처 많이 가는 음식점은 어디일까	고려대 근처 많이 가는 음식점	2
민자가 어젯밤 메일을 몇 통이나 보냈어	민자 어젯밤 보낸 메일 수	2
막내의 개학이 며칠인데	막내 개학 날짜	2
저번 주 이후로 전화 안 받더니 뭐했어 	저번 주 이후로 한 것	2
현재 원효대교 북단은 교통이 원활하니	현재 원효대교 북단 교통 상황	2
내가 주식을 직접 사는 게 좋을까 증권회사에 맡기는 게 좋을까	주식을 직접 살지 증권회사에 맡길지	1
아직 해약하지 말고 그냥 둬	해약하지 말고 그냥 둘지	0
오늘 온 편지 중 첨부 파일이 든 메일은 얼마나 되지	오늘 온 편지 중 첨부 파일이 든 메일 수	2
인천공항 근처 롯데리아 어딘데	인천공항 근처 롯데리아 위치	2
자격증 따려고 하는데 뭐가 좋을까	따기 좋은 자격증	2
요즘 카드는 연회비가 없어	요즘 카드 연회비 여부	0
장학금 타려면 학점 얼마 이상이어야 해	장학금 타는 학점	2
요즘 예금 상품이 많던데 뭐가 좋은 건지 모르겠어	좋은 예금 상품	2
이 열차는 침대차 있나요	열차 침대차 여부	0
벌써 아르바이트 구했구나 어떤 아르바이트야 	아르바이트 정체	2
거기도 비오니	거기 비 오는지	0
고평가된 주식의 가능성은 어느 정도지	고평가 주식 가능성	2
현재 황사 경보가 내려진 지역은 어디지	현재 황사 경보 지역	2
서울에서 제일 큰 교회는 어디지	서울 제일 큰 교회	2
보낸 편지함에 편지가 몇 개나 있어	보낸 편지함 편지 수	2
남이섬갈 때 뭐타고 가	남이섬 가는 방법	2
수영장 있나요	수영장 여부	0
비행기편 변경 가능한가요	비행기편 변경 가능 여부	0
이번에 학교에서 하는 스노보드 강좌 들었니	이번 학교 스노보드 강좌 수강 여부	0
네 카드 월간 한도액 얼마야	카드 월간 한도액	2
많이 아파	많이 아픈지	0
엄마 혈압약 이름이 뭐였더라 	엄마 혈압약 이름	2
내일 수업시간 바뀌었대	내일 수업시간 바뀌었는지	0
너네는 조별 발표 없어 우린 학점을 전체적으로 준대	조별 발표 여부	0
나 여행갈 때 환전하려고 하는데 아무 은행에서 해도 돼	아무 은행에서 환전해도 되는지	0
석유 값하고 주식하고 어떤 관계가 있지 	석유 값 주식 관계	2
명동 소재 백화점은 어디더라	명동 소재 백화점 위치	2
우리나라의 국경일이 언제	우리나라 국경일	2
왜 일본 스키장에 가려고 하는 거지 	일본 스키장 가려는 이유	2
앞으로 더 가면 유턴하는 곳이 있어	앞으로 더 가면 유턴하는 곳 있는지	0
방배동 파출소는 어디니	방배동 파출소 위치	2
이번에도 학교에서 테니스 하니	학교에서 테니스 하는지	0
부산대 인근 볼링장 어디래	부산대 인근 볼링장 위치	2
소림사에 인접한 절이 어디니	소림사 인접한 절	2
언니 발레레슨은 사월에 개강이래	발레레슨 사월 개강 여부	0
이메일 오빠한테 보내	이메일 오빠한테 보낼지	0
서울 부산 간 고속철 운임은 얼마냐	서울 부산 간 고속철 운임	2
나의 발표 언제일까	나의 발표 날짜	2
가계대출은 이자가 얼마야 	가계대출 이자	2
여기서 대전까지는 정체 구간이니	대전까지 정체 구간 여부	0
오늘 메일 중 첨부 파일이 든 메일 얼마나 될까	오늘 메일 중 첨부 파일 든 메일 수	2
대학교 등록금 마감일이 언제야	대학교 등록금 마감일	2
수상스키 처음 타는데 뭘 준비해야 할까	수상스키 준비할 것	2
경부 고속도로에 노면이 결빙된 구간은 어딘데	경부 고속도로 노면 결빙 구간 위치	2
날씨 좋으면 야외수업한대	날씨 좋으면 야외수업하는지	0
오늘 조회 끝나고 소지품 검사 한대	오늘 조회 끝나고 소지품 검사 하는지	0
주식 시장의 붕괴가 대공황으로 이어질까	주식 시장 붕괴 대공황 여부	0
너 어릴 때 태권도 배웠지	어릴 때 태권도 배웠는지	0
거기 눈오니	거기 눈 오는지	0
지금 운전중	지금 운전중인지	0
신호 위반하면 벌금이 얼만데	신호 위반 벌금	2
배 다쳤어	배 다쳤는지	0
지금 회사야	지금 회사인지	0
구월 십일이 바로 그날이야	구월 십일이 그날인지	0
회사 위치가 어디야 너 일하는 모습 좀 보게	회사 위치	2
모레 부산의 기온이 얼마나 될까	모레 부산의 기온	2
주식이 오른다는 예상은 어떤 과정을 통해 나온 건가요	주식 오른다는 예상 나온 경위	2
야간자율학습 하던 때가 그립지 않니 	야간자율학습 하던 때가 그립지 않은지	0
가계의 주식투자 결정요인은 무엇인가 	가계 주식투자 결정요인	2
언니는 이주 운동하고 효과 봤어	이주 운동 효과 봤는지	0
오늘 대구의 풍속은 얼마지	오늘 대구 풍속	2
형 오늘 언제 갈껀지 조금 있으면 많이 막힐 것 같음	오늘 가는 시간	2
안 잊어 버렸어	안 잊어 버렸는지	0
스코어는 몇 점이에요	스코어	2
입원했다더니 얼마나 많이 다친 거니	다친 정도	2
주요 고속도로의 노면상황 좋지	주요 고속도로 노면상황 좋은지	0
학교에서 셔틀버스 타면돼	학교에서 셔틀버스 타면 되는지	0
지난 번 말했던 견적서는 취소됐어	지난 번 견적서 취소됐는지	0
이번 동계 올림픽 개최지가 어느 나라인지 생각이 안 나	이번 동계 올림픽 개최지 국가	2
학교 언어교육원을 다닐까 아니면 집 근처 학원을 다닐까 회화학원을 다닐까 너무 고민돼	학교 언어교육원 집 근처 학원 회화 학원 중 다닐 것	1
이 열차는 몇 번 플랫폼에서 출발해요	열차 출발 플랫폼	2
양재동에 아동 전문 병원이 있나	양재동 아동 전문 병원 여부	0
입원했다더니 얼마나 많이 다친 거니	다친 정도	2
서울 특산품이 뭐니	서울 특산품	2
정통부 사 세대 이동 통신개발 관련 소식 뭐지	정통부 사 세대 이동 통신개발 관련 소식	2
보유지분 매각 검토되고 있어	보유지분 매각 검토 여부	0
지금 어디까지 오셨어요	지금 어디까지 왔는지	2
옵션 가격 결정요인이 뭐니	옵션 가격 결정요인	2
몇 번 게이트였죠	게이트 번호	2
사원 출입 카드 재발급 하려면 어떻게 해야 되죠	사원 출입 카드 재발급 방법	2
오늘은 맑아요	오늘 맑은지	0
생일 케익도 미리 맞춰뒀어	생일 케익 미리 맞춰뒀는지	0
서울에서 안 아프게 치료하는 곳으로 유명한 치과	서울 안 아프게 치료하는 치과	2
현재 경부 고속도로의 날씨는 어떻니	현재 경부 고속도로 날씨	2
테크노마트 갈까 용산전자상가 갈까 네가 정해	테크노마트 용산전자상가 중 갈 곳	1
부산대학교 앞 이비인후과 어떻게 가니	부산대학교 앞 이비인후과 가는 방법	2
나는 거의 도착했는데 너는 어디쯤이야 	현재 위치	2
회사에 가고 있어	회사 가고 있는지	0
국제 유가가 세계 증시에 미치는 영향이 뭔가요 	국제 유가 세계 증시 영향	2
올해 프로농구 개막일이 언제지	올해 프로농구 개막일	2
현장학습을 가면 좋은 점이 뭐가 있나요 	현장학습 장점	2
오늘 새 편지 중 정미가 보낸 메일 몇 통이니	정미가 보낸 메일 수	2
시험 붙을 때까지 친구 안 만나 	시험 붙을 때까지 친구 안 만날지	0
지하철역 주변에 조흥은행 씨디기 없어	지하철역 주변 조흥은행 씨디기 여부	0
유아 구강 건강 관리는 어떻게 해야 하나요 	유아 구강 건강 관리 방법	2
외국인 투자자들의 움직임은 어때	외국인 투자자들 움직임	2
어느 계좌인지를 모르겠다	어느 계좌인지	2
인터넷 뱅킹 신청하려면 뭐 뭐 필요해 	인터넷 뱅킹 신청 필요한 것	2
내일 그룹 스터디 하는 날이야	내일 그룹 스터디 하는지	0
실질 이자 효과가 어떻게 되는데 	실질 이자 효과	2
요즘 뭐하고 지내 학교는 잘 다니고 있지	학교 잘 다니는지	0
그 은행에 가면 주민번호를 불러 줘야 해	그 은행 가면 주민번호 불러 줘야 하는지	0
얼마야	얼마인지	2
청담동에 가려면 뭐 타고 가야 하냐 	청담동 가는 방법	2
현관에 온 사람이 있나	현관 사람 여부	2
다음 주 학과장 회의가 몇 시지	다음 주 학과장 회의 시간	2
어디서 몇시에 볼까	만나는 장소 시각	2
어젯밤 보낸 이메일 중 송신 확인 안 된 이메일은 얼마나 되냐	어젯밤 보낸 이메일 중 송신 확인 안 된 이메일 수	2
생일파티 하려고 하는데 이번 주 토요일이랑 일요일 중에 언제가 더 좋아	생일파티 이번주 토요일 일요일 중 좋은 것	1
서울 시내 사고 통제 구간은 몇 곳이나 돼	서울 시내 사고 통제 구간 수	2
디브이디 꺼내	디브이디 꺼내는지	0
오늘 새 편지 중 정미 아이디로 된 메일이 있니	오늘 새 편지 중 정미 아이디로 된 메일 여부	0
서울 특산품이 뭐니	서울 특산품	2
주식을 계속 보유해야 배당금이 나와	주식 계속 보유해야 배당금이 나오는지	0
여기는 비 오는데 거기도 비와요 	거기 비 오는지	0
고려대 근처 롯데리아는 어떻게 가는가	고려대 근처 롯데리아 가는 방법	2
이번에 얼마 가지고서 제주도 다녀온 거냐	제주도 다녀온 비용	2
수영을 해도 살이 안 빠져	수영을 해도 살이 안 빠지는지	0
선경이 인턴 끝내고 귀국 했대요	선경이 인턴 끝내고 귀국 했는지	0
올해부터 교육비 세금 공제 안 된데	올해 교육비 세금 공제 여부	0
이번에 나는 안경을 바꿨어 뿔테로 너는 별 소식 없어 	별 소식 없는지	0
과제 아무도 안 해와서 교수님 화나셨어	교수님 화나셨는지	0
요즘 운동해 살이 쭉 빠졌더라	요즘 운동하는지	0
신용평가가 주식에 미치는 영향을 알고 싶은데	신용평가 주식 영향	2
내일 서울의 비가올 확률은 얼마지	내일 서울 비 확률	2
너 어디야 왜 아직도 안 나오는 거야 	위치	2
야간 셔틀버스 몇 시까지 다니니	야간 셔틀버스 시간	2
등록금 언제까지 내야하니	등록금 납부 기한	2
오늘 종로 시내의 교통상황은 어때	오늘 종로 시내 교통상황	2
오늘 현재 강남대로 부근 정체구간은 어디니	오늘 현재 강남대로 부근 정체구간	2
이번 주 전국의 날씨는 어떻지	이번 주 전국 날씨	2
어학연수 계획하는 거야	어학연수 계획하는지	0
주유 할인 및 영화 할인하는 신용카드는 없나요 	주유 및 영화 할인 신용카드	2
은행 이율은 지점마다 다르지 않아	은행 이율 지점마다 다른지	0
현금으로 드릴까요 수표로 드릴까요	현금 수표 중 줄 것	1
형 오늘 언제 갈껀지 조금 있으면 많이 막힐 것 같음	오늘 가는 시각	2
땀을 흘려야 살이 빠지지	땀 흘려야 살 빠지는지	0
배 괜찮아	배 괜찮은지	0
트럭과 포크레인이 박으면 어떤 것이 더 많이 망가질까 	트럭 포크레인 중 박으면 더 많이 망가지는 것	1
한 시간쯤 후에 마칠 것 같은데 그때도 가능해	한 시간 쯤 후 가능 여부	0
이마트 세일 기간이 어떻게 되지	이마트 세일 기간	2
일 종 면허는 어떻게 취득하죠	일 종 면허 취득 방법	2
그 역 갈아타는 곳 많이 걸어야 돼	그 역 갈아타는 곳 많이 걸어야 되는지	0
부산대 부근 피자헛 매장은 어디	부산대 부근 피자헛 매장 위치	2
그래도 교양 쪽은 휴강 좀 하겠지	교양 쪽 휴강할지	0
주식형 펀드와 적금 중에 뭘 하는게 좋을까	주식형펀드 적금 중 좋은 것	1
속초에 있는 해수욕장의 현재 기온은 얼마니	속초 해수욕장의 현재 기온	2
우와 몇 킬로 하는데	무게	2
과연 졸업 후에 전공을 살려서 취업할 수 있겠어 	졸업 후 전공 살려 취업 가능 여부	0
세탁기에 빠져서 돈이 찢어졌는데 교환 받을 수 있나요 	찢어진 돈 교환 가능 여부	0
동생방에 동생들이 있니	동생방 동생들 있는지	0
오늘부터 백 일 뒤가 몇 월 며칠이야	백 일 뒤 날짜	2
서울역 근처에 맛있는 김밥집은 어디에 있어	서울역 근처 맛있는 김밥집 위치	2
구덕 터널이 붐비니	구덕 터널 붐비는지	0
골프연습장이 어디가 괜찮지	괜찮은 골프 연습장	2
보낸 메일 중 되돌아 온 메일은 몇 통이지	보낸 메일 중 되돌아 온 메일 수	2
소호는 이쪽인가요	소호 이쪽인지	0
지하철 요즘도 위험하니	지하철 요즘도 위험한지	0
그럼 넌 이제 뭐 하는 거야	이제 하는 것	2
여의나루역 근처 우체국은 어디지	여의나루역 근처 우체국 위치	2
우산 안 가져왔으면 나랑 같이 쓸래	우산 같이 쓸지	0
가격제한폭이 위아래로 십오퍼센트 아닌가	가격제한폭 위아래 십오퍼센트 여부	0
나랑은 관계없는 일이야	나랑 관계없는지	0
경인고속도로의 전용차선 상황은 어때	경인고속도로 전용차선 상황	2
주말은 좀 그렇고 월요일은 어때	월요일 어떤지	0
자사주를 고가로 매입했다는데 왜 일까 	자사주 고가 매입 이유	2
조깅하면 한 시간에 몇 칼로리가 소모될까	조깅 한 시간 소모 칼로리	2
춘천 가려면 무슨 터미널로 가야 돼요	춘천 가는 터미널	2
마을버스 없어 	마을버스 여부	0
오늘 서울의 한낮 체감온도는 얼마지	오늘 서울 한낮 체감온도	2
영어회화 유창하게 하는 법 없을까 	영어회화 유창하게 하는 법	2
갑자기 왜 유학을 보내려고 	갑자기 유학 보내려는 이유	2
서울시 소재 전자상가가 어디지	서울시 소재 전자상가	2
방 값 얼마래	방 값	2
저 쇼핑센터는 몇 시에 닫나요	쇼핑센터 닫는 시간	2
저번에 했던 약속은 아직 유효한거지 	저번 약속 유효한지	0
부산 시내 정체구간은 어디래	부산 시내 정체구간	2
괜찮아 	괜찮은지	0
증권거래소는 뭐 하는 곳이죠	증권거래소 하는 일	2
요즘 건강은 어때	요즘 건강한지	0
블루 노트라는 나이트클럽 들어보셨나요	블루 노트 들어 봤는지	0
부산 해운대에 어떤 곳이 좋지	부산 해운대 좋은 곳	2
내일 아침 지역별 안개 분포 현황 어떻게 되지	내일 아침 지역별 안개 분포 현황	2
오늘 오전에 도착한 메일은 몇 통일까	오늘 오전 도착 메일 수	2
인사과에서 왜 우리한테 그러는 거야	인사과에서 그러는 이유	2
한 방에 몇 명인가요	한 방 인원	2
보험 혜택은 어느 정도지	보험 혜택 정도	2
보험이 나을까 적금이 나을까	보험 적금 중 나은 것	1
독감 예방 주사는 맞았니 	독감 예방 주사 맞았는지	0
내일 오존 경보지수가 얼마나 되지	내일 오존 경보지수	2
이 카드 은행에서 발급받을 수 있어	이 카드 은행에서 발급 가능한지	0
투자자들의 동향은 어떻습니까	투자자 동향	2
홈쇼핑이 더 유리할 수도 있어	홈쇼핑 더 유리할 수 있는지	0
이번 달 공휴일은 언제냐	이번 달 공휴일	2
천호동에서 상일 인터체인지까지 흐름이 어떻지	천호동에서 상일 인터체인지까지 흐름	2
회계팀은 다른 부서보다 일이 많은 편이래	회계팀 다른 부서보다 일 많은지	0
우리 거기서 만날까	거기서 만날지	0
서울에서 라식수술을 잘하는 안과는 어떻게 간데	서울 라식수술 잘하는 안과 가는 방법	2
버스가 좋을까 지하철을 타고 가는 것이 빠를까	버스 지하철 중 빠른 것	1
말이 빨라서 못 알아듣겠어	말 못 알아듣겠는지	0
어제 시험 끝내고 좀 여유가 생겼나	여유가 생겼는지	0
이번 주 토요일에 근무하나	이번 주 토요일 근무 여부	0
부산역 근처 삼성 에이에스센터가 어떻게 가	부산역 근처 삼성 에이에스센터 가는 방법	2
부모님도 모두 안녕하시니	부모님 안녕하신지	0
압구정동 근처 미용실 어딘데	압구정동 근처 미용실	2
저녁에 과외선생님 오셔	저녁 과외선생님 오시는지	0
해운대에서 연인들이 제일 많이 찾는 커피숍은 어디지	해운대 연인들 제일 많이 찾는 커피숍	2
비즈니스석은 얼마지	비즈니스석 가격	2
웨이트랑 유산소랑 어떻게 조정해야 되는 거야	웨이트 유산소 조정 방법	2
서초구에 있는 도서관은 어떻게 가	서초구 도서관 가는 방법	2
별일은 없고	별일 없는지	0
내일 비가 오면 자전거 타기로 한거 취소해야겠지 	내일 자전거 취소 여부	0
고신의료원 근처 편의점은 어디니	고신의료원 근처 편의점	2
무교동 주변의 낙지전문점은 어디지	무교동 주변 낙지전문점	2
지호 훈련 가는 날짜가 언제야	지호 훈련 날짜	2
논문 발표하러 일본가는 날이 언제야	일본가는 날짜	2
친구 아버님이 병원에 계셔	친구 아버님 병원에 계신지	0
저한테 맞는 것 있나요	저한테 맞는 것 있는지	0
탄천 타라서 자전거 타고 가면 더 빨리 갈 수 있어	탄천 타라서 자전거 타고 가면 더 빠른지	0
혈압 약은 거르지않고 잘 드시고 있나요	혈압 약 잘 먹는지	0
흰 눈 사이로 썰매나 탈까	썰매 탈지	0
월례고사는 국어 영어 수학만 봐요	월례고사 국어 영어 수학만 보는지	0
한 방에 몇 명인가요	한 방 인원	2
얼마나 멀어요	거리	2
취직하고 첫 월급인데 많이 받았어	월급 많이 받았는지	0
중국에서 친구 사귀었어요	중국에서 친구 사귀었는지	0
안방 가서 급탕 스위치 끄니	안방 가서 급탕 스위치 끌지	0
광안리 인근 놀이공원은	광안리 인근 놀이공원	2
성수대교남단에서 도산사거리 사이 도로 정보는	성수대교남단에서 도산사거리 사이 도로 정보	2
분식집 요즘 잘 되나	분식집 요즘 잘 되는지	0
과장님 늦둥이 낳으셨데	과장님 늦둥이 낳으셨는지	0
오늘 약속 있냐	오늘 약속 여부	0
오늘 노래방에서 약속이 있어	오늘 노래방에서 약속 있는지	0
한시에 무슨 과목 수업이 있지	한시 수업 과목	2
지금 쫌 빨리 가는 방법이 없을까	빨리 가는 방법	2
어젯밤 보낸 이메일 중 송신이 확인된 이메일 몇 통이니	어젯밤 보낸 이메일 중 송신 확인된 이메일 수	2
저 사람이랑은 관계없어	저 사람 관계없는지	0
재산증식을 위한 금융상품은 뭐가 좋을까	재산증식 위한 금융상품	2
초대 받아야만 계정을 만들 수 있어	초대 받아야 계정을 만들 수 있는지	0
이번 시험 커트라인이 몇 점이야	이번 시험 커트라인	2
현재 중부 상행선에서 교통이 통제되는 구간은 어디야	현재 중부 상행선 교통 통제 구간	2
입추가 언제지	입추 날짜	2
주식 같은 건 어디가야 배울 수 있어	주식 배울 곳	2
초등학교 동창회 날이 언제야	초등학교 동창회 날짜	2
내일 오륙도의 파고는 얼마나 높지	내일 오륙도 파고	2
칠월 삼일이 공휴일이야	칠월 삼일 공휴일 여부	0
서초동 인근 빨래방은 어떻게 가지	서초동 인근 빨래방 가는 방법	2
한화 우선주의 외국인 보유 비중이 제일 높아	한화 우선주 외국인 보유 비중 제일 높은지	0
업종지수를 살피는 것은 그날의 테마주를 찾기 위해서야	업종지수 살피는 것은 그날의 테마주를 찾기 위해서인지	0
교육 사이트는 어디가 좋을까 	좋은 교육 사이트	2
저 같은 경우는 어떻게 주식투자를 준비해야 합니까	주식투자 준비 방법	2
동대문에서 저렴한 맥주집은 어디일까	동대문 저렴한 맥주집	2
유월 구일날 데모해	유월 구일날 데모하는지	0
생전에 유언장을 남겼어	생전 유언장 남겼는지	0
주변에 주식 하는 사람 없어 뭐 물어볼게 있는데	주변 주식하는사람 없는지	0
마늘이 수은 해독에 좋대	마늘이 수은 해독에 좋은지	0
리모델링 받아서 되팔 거야	리모델링 받아 되팔지	0
너 배 타고 외국 가 본 적 있어	배 타고 외국 가 본 적 있는지	0
어젯밤 온 메일 중 첨부 파일이 든 메일 얼마나 될까	어젯밤 온 메일 중 첨부 파일이 든 메일 수	2
판테온 포함인가요	판테온 포함 여부	0
경부 고속도로에 노면 결빙 구간은 어떨까	노면 결빙 구간 상태	2
다음 공략 목표는 어디인지요	다음 공략 목표	2
어떤 방이 마음에 드세요	마음에 드는 방	2
주식 보유 비품도 정체야	주식 보유 비품 정체인지	0
동국대앞 호텔은	동국대앞 호텔	2
어제 보낸 메일 중 수신 확인된 메일은 얼마나 되는가	어제 보낸 메일 중 수신 확인된 메일 양	2
주유할 때 포인트제일 많이 쌓이는 카드가 어떤 거야 	주유 포인트 제일 많이 쌓이는 카드	2
신림역에서 신촌까지 가는 교통편이 어떻게 돼요	신림역 신촌 가는 교통편	2
모의 주식투자 할 수 있는 사이트 어디예요	모의 주식투자 할 수 있는 사이트	2
미 상공회의소 회장과 인터뷰 기사는 뭐냐	미 상공회의소 회장과 인터뷰 기사	2
비오는 날에 음악 들으면 기분 좋아져	비오는 날 음악 들으면 기분 좋아지는지	0
전주행 열차를 예매할 거야	전주행 열차 예매할지	0
막내가 집에 돌아오는 시간은 언제야	막내 집 돌아오는 시간	2
그럼 필수교양 다 들은 거야	필수교양 다 들었는지	0
결제 자동이체로 바꿨어	결제 자동이체로 바꿨는지	0
난 정말 만나기 싫어	난 정말 만나기 싫은지	0
그날은 안돼	그날은 안되는지	0
내년 어머니 생신은 무슨 요일이야	내년 어머니 생신 요일	2
아침식사 하게 되면 숙박료가 얼마지	아침식사 포함 숙박료	2
과장님 내일부산가시기로 하신거 취소됐어요	내일 부산행 취소 여부	0
골프장 근처 호텔 예약할래	골프장 근처 호텔 예약할지	0
언제쯤 원가 회복할까	원가 회복 시기	2
지금 구로역인데 맨 앞 칸에서 타면 만날 수 있어 	구로역 맨 앞 칸에서 타면 만날 수 있는지	0
길가다가 차가 멈췄어	길가다 차가 멈췄는지	0
언니 장염 걸린 건 괜찮아 왜 그런 거야 	장염 괜찮은지	0
강원도 지역에 눈이 얼마나 왔지	강원도 지역 눈 양	2
아침식사가 되는 것으로 예약할래	아침식사 되는 것으로 예약할지	0
보낸 이 이름이 영어로 된 이메일 있니	보낸 이 이름 영어 이메일 여부	0
티켓 예매할 때 학생요금 할인되나요 	티켓 예매 학생요금 할인 여부	0
괜찮아	괜찮은지	0
연구사님 교육부 들어 가셨데요	연구사님 교육부 들어 가셨는지	0
주말에 은행 업무를 하는 곳이 없나 	주말 은행 업무 하는 곳	2
어디쯤 왔어 도착할 때쯤 전화해	어디쯤 왔는지	2
스쿼시랑 라켓볼이랑 어느 쪽이 더 어렵니	스쿼시 라켓볼 중 어려운 것	1
증권사들이 향후 전망이 갑자기 비관적이 된 이유가 뭐죠	증권사들 향후 전망 비관 이유	2
그 연예인이 요즘 제일 잘 나가	그 연예인 요즘 제일 잘 나가는지	0
폐장하기 전에 또 한 번 갈까	폐장 전 또 갈지	0
어느 은행이 이율이 제일 높을까	이율 제일 높은 은행	2
결혼기념일이 언제야	결혼기념일	2
강남에서 제일 물 좋은 나이트는 어디지	강남 제일 물 좋은 나이트	2
우리 회사의 문제점이 뭐라 생각하십니까	우리 회사 문제점	2
초복이 언제지	초복 날짜	2
태성이 학교 운동회가 언제야	태성이 학교 운동회 날짜	2
다른 친구에게 연락해	다른 친구에게 연락하는지	0
라켓이랑 공은 다 있고	라켓 공은 다 있는지	0
현재 황사 주의보 내려진 지역은 어때	현재 황사주의보 내려진 지역 상황	2
자신 있지	자신 있는지	0
고속터미널이랑 남부터미널 중에 어디로 가야 돼	고속터미널 남부터미널 중 갈 곳	1
우리 학교에는 등산 동아리 없니	학교 등산 동아리 여부	0
요번 주 전국 날씨는 어때	요번 주 전국 날씨	2
컴퓨터가 갑자기 느려졌어	컴퓨터가 갑자기 느려졌는지	0
인천국제공항 고속도로 구간의 교통 흐름은	인천국제공항 고속도로 구간의 교통 흐름	2
주가를 인위적으로 올리는 방법은 불법인가요 	주가 인위적 상승 불법 여부	0
혹시 피비알과 피이알 차이가 뭔지 알아 	피비알 피이알 차이점	2
이제 해외 시장으로 눈을 돌려 보려고	해외 시장으로 눈을 돌리는지	0
주식시장의 불법행위는 어떠한 것들이 있나요 	주식시장 불법행위	2
이 도로에 교통 사고가 발생했니	이 도로에 교통 사고가 발생했는지	0
설 연휴에 동창회 한데	설 연휴 동창회 여부	0
수상스키 처음 타는데 뭘 준비해야 할까	수상스키 준비할 것	2
커트만요	커트만 할지	0
요즘에 학교운동장 다섯 바퀴씩 뛰어	요즘 학교운동장 다섯 바퀴씩 뛰는지	0
모레 눈 올 확률은 얼마니	모레 눈 올 확률	2
오월 이일날 입급했어	오월 이일날 입급 여부	0
그는 어떤 사람인가요	그가 어떤 사람인지	2
너 네 집 근처에 한미은행 있지	집 근처 한미은행 있는지	0
서울대 주변 정형외과는	서울대 주변 정형외과	2
예금자 보호 최대한도가 얼마지	예금자 보호 최대한도	2
그동안 잘 지내셨어요	잘 지냈는지	0
대학 테니스 우승자 관련 기사는 없을까	대학 테니스 우승자 관련 기사	2
보험 종류에는 종신보험 외에 또 어떤 것들이 있지요	종신보험 외 보험 종류	2
명예 퇴직하면 퇴직금이 많아	명예 퇴직하면 퇴직금 많은지	0
오늘은 맑아요	오늘 맑은지	0
수요일이랑 목요일 중 언제가 좋아	수요일 목요일 중 좋은 때	1
내가 얼마의 주식을 보유해야 그 회사 경영에 참여할 수 있지	회사 경영 참여 가능 주식 양	2
바쁘니	바쁜지	0
내가 얼마의 주식을 보유해야 그 회사 경영에 참여할 수 있지	회사 경영 참여할 수 있는 주식 보유량	2
올 거야 말 거야	올 건지 말 건지	0
광명역 근처의 독일 레스토랑 어떻게 가	광명역 근처 독일 레스토랑 가는 방법	2
난센스 퀴즈 오뎅을 다섯 글자로 늘이면	오뎅 다섯 글자로 늘인 것	2
호텔 예약일이 언제니	호텔 예약일	2
요즘 경제 최고의 이슈는 뭐니	요즘 경제 최고의 이슈	2
오늘 오후에 올라가는 기차 취소해	오늘 오후 올라가는 기차 취소하는지	0
내가 주번 언제 하지	내가 주번 할 시기	2
카드 유효기간이 끝나려고 하는데 연장할 수 있나요 	카드 연장할 수 있는지	0
어느 은행이 자산 구조가 탄탄해 	자산 구조 탄탄한 은행	2
일본으로 전화하려면 몇 번을 처음에 눌러야 하나요	일본 전화 처음에 누를 것	2
해운대 달맞이 고개에 있는 레스토랑은	해운대 달맞이 고개 레스토랑	2
숙소 인터넷 예약한거 완료 됐어	숙소 인터넷 예약 완료 됐는지	0
우리나라 주식의 시세를 예측할 수 있어	우리나라 주식 시세 예측 가능 여부	0
설안사 소청봉에 비가 내릴 확률은 어떻게 되지	설안사 소청봉 비 내릴 확률	2
업무를 위임한 사람들과 자주 연락을 하세요	업무 위임한 사람들과 자주 연락하는지	0
일본은 지금 몇 시에요	일본 지금 시각	2
한강대교 진출입 상황은 원활한가	한강대교 진출입 상황	2
자동이체 신청 하려면 뭐 필요한지 알아 	자동이체 신청 필요한 것	2
아침식사 안 하면 숙박료가 얼마야	아침식사 없는 숙박료	2
통합보험이랑 종신보험이랑 뭐가 다른지 알아	통합보험 종신보험 차이점	2
거기서 분당 가는 버스 없어	거기서 분당 가는 버스 여부	0
늦을꺼 같아	늦을꺼 같은지	0
회사에서 의료비 지원을 해주니	회사 의료비 지원 여부	0
취약과목은 어떻게 해야할지 모르겠어	취약과목 공부법	2
시험시간에 커닝하다가 들켰어	시험시간에 커닝하다 들켰는지	0
수술하고 방귀 뀌어야 한다는데 뀌었어 	수술하고 방귀 뀌었는지	0
언니 보고 싶어서 눈이 짓물렀어요 우리 언제 보는 거죠 	보는 시기	2
잘 지내는지 궁금하네	잘 지내는지	0
외국에서 뜨는 사업이 뭐가 있을까 	외국에서 뜨는 사업	2
우선 버스 타고 의정부로 가있어	버스 타고 의정부로 가있을지	0
투자할 때 제일 먼저 고려돼야 할 사항은 뭐지 	투자 시 제일 먼저 고려할 사항	2
버스가 좋을까 지하철을 타고 가는 것이 빠를까	버스 지하철 중 빠른 것	1
명동 부근 카레 전문점 어디에 있어	명동 부근 카레 전문점 위치	2
주식형 펀드와 적금 중에 뭘 하는게 좋을까	주식형 펀드 적금 중 좋은 것	2
기한까지 리포트 완성하기 힘들어	기한까지 리포트 완성하기 힘든지	0
주식하고 증권 뭐가 다르지	주식 증권 차이	2
휴면 통장은 자동으로 폐쇄 되는 거야	휴면 통장 자동 폐쇄 여부	0
혼났어	혼났는지	0
은경이가 행정고시 이차까지 합격했데	은경이 행정고시 이차까지 합격했는지	0
서울에서 라식수술을 잘하는 안과는 어디일까	서울 라식수술 잘하는 안과	2
직불 카드 많이 써야 공제 받을 수 있어	직불 카드 많이 써야 공제 받을 수 있는지	0
주식회사라는 말은 전부다 상장기업임을 의미합니까	주식회사 상장기업 의미 여부	0
자기앞 수표 발행 자격이 어떻게 돼요	자기앞 수표 발행 자격	2
소이 방 에어컨 이십 오 도로 맞추니	소이 방 에어컨 이십 오 도로 맞추는지	0
교육 사이트는 어디가 좋을까 	좋은 교육 사이트	2
슈트 빌리는데 오 만원 이었나	슈트 빌리는 가격	2
양재동에서 교육문화회관은 어떻게 간데	양재동 교육문화회관 가는 방법	2
민호야 영어 숙제 다 했어	영어 숙제 다 했는지	0
국수 먹고 싶어	국수 먹고 싶은지	0
언제 갈까	갈 시간	2
부산대 주변 나이트 클럽 어디니	부산대 주변 나이트클럽 위치	2
오전 중으로 입금 해야 모레 받아 볼 수 있대	오전 중으로 입금 해야 모레 받아 볼 수 있는지	0
서울에서 분위기가 제일 좋은 스카이 라운지의 위치는 어디냐	서울 분위기 제일 좋은 스카이 라운지 위치	2
경부 고속도로 정체구간 어딘데	경부 고속도로 정체구간 위치	2
지하철도 위험해서 타기 싫어	지하철 타기 싫은지	0
행정법도 들을 예정인데 수요일 아침이 좋을까 오후가 좋을까	행정법 수요일 아침 오후 중 좋은 것	1
업무의 능률을 올리는 방법이 있을까 	업무 능률 올리는 방법	2
요새 많이 춥다고 하는데 감기는 안 걸렸니 	감기 안 걸렸는지	0
야 너네 동네 물난리 났던데 너네 집은 어때	물난리 집 괜찮은지	0
내일 조회 필드발표 준비했냐	내일 조회 필드발표 준비 여부	0
읽어 본 편지는 몇 개나 있어	읽어 본 편지 수 	2
비 오는 한강에 뭐 특별히 볼 거라도 있어 	비 오는 한강 볼 것	2
이번 주 일요일이 곗날 맞지	이번 주 일요일 곗날 맞는지	0
이번에 회사에서 스톡옵션 받았어	이번에 회사 스톡옵션 받았는지	0
내일 카드 다 정지 시킬 거야	내일 카드 다 정지 시킬지	0
옵션 가격 결정요인이 뭐니	옵션 가격 결정요인	2
방금 카메라에 찍힌 거 같은데 어쩌지	카메라 찍힌 상황 대책	2
내일 스쿼시 수업 갈 거야 	내일 스쿼시 수업 갈지	0
상승률 상위는 오늘 주식의 대세를 말하는 것이야	상승률 상위는 오늘 주식 대세 말하는 것인지	0
우리나라 황금사원은 어디에 있는가	우리나라 황금사원 위치	2
청담동에서 개그맨들이 많이 찾는 포장마차는 어떻게 갈까	청담동 개그맨들 많이 찾는 포장마차 가는 방법	2
텝스 점수도 인정하나요	텝스 점수도 인정하는지	0
어제 습도 얼마였어	어제 습도	2
수업 한 시간 늦춰졌대	수업 한 시간 늦춰졌는지	0
모레 지호엄마 몇 시에 어디서 만나기로 했지	모레 지호엄마 만나기로 한 시간 장소	2
방문 목적은 어떻게 되세요	방문 목적	2
서울역 주변 냉면이 가장 맛있는 음식점은 어디니	서울역 주변 냉면이 가장 맛있는 음식점	2
그 친구는 외국 바이어들이 오면 접대해	그 친구 외국 바이어 접대하는지	0
여기는 무슨 역인가요	현재 역	2
종목에 없는 주식회사는 왜 그런 거지 	종목에 없는 주식회사 이유	2
인터넷 환전 서비스가 과연 안전할까 의심이 가	인터넷 환전 서비스 안전 여부	0
신용등급과 회사채의 등급을 어떻게 알아볼 수 있을까요	신용등급 회사채 등급 알아보는 방법	2
내일이 음력으로 언제야	내일 음력 날짜	2
블루 노트라는 나이트클럽 들어보셨나요	블루 노트 들어 봤는지	0
목표 수익율이 몇이십니까	목표 수익율	2
그동안 연락도 없이 뭐하면서 지냈어 	근황	2
주식 배당금 탄 걸로 뭐할 거야	주식 배당금 사용 계획	2
지금 연체 중이야	지금 연체 중인지	0
대리운전 불러	대리운전 부를지	0
송파구 가락동 근처 패밀리 레스토랑 어떻게 가는가	송파구 가락동 근처 패밀리 레스토랑 가는 방법	2
눈 오는 날은 운전하기 어려워	눈 오는 날 운전하기 어려운지	0
내일 아침 삼척의 습도는	내일 아침 삼척 습도	2
인터넷 쇼핑하는 거 괜찮을까 	인터넷 쇼핑 괜찮을지	0
왜 일본 스키장에 가려고 하는 거지 	일본 스키장 가는 이유	2
둘째 귀염둥이는 잘 지내고 있나요	둘째 잘 지내는지	0
신입생들이 질문하면 못 들은 척 할 거예요	신입생 질문 못 들은 척 할지	0
보통주와 우선주는 뭐가 다른 거지 	보통주 우선주 차이점	2
서울 구리 간 국도 상황이 어떻지	서울 구리 간 국도 상황	2
언니 결혼식이 벌써 다음 주예요	결혼식 다음 주인지	0
정보처리 실습 꼭 들어야 되요	정보처리 실습 꼭 들어야 되는지	0
가을 여행까지 얼마나 남았지	가을 여행까지 남은 기간	2
아이티 계열이 왜 주식이 올라	아이티 계열 주식 오르는 이유	2
누구랑 약속이 있지	약속한 사람	2
감기엔 오렌지쥬스가 좋아	감기 오렌지쥬스 좋은지	0
현재 서울의 강우량은 얼마나 되지	현재 서울 강우량	2
무선 인터넷 관련 기사 뭔가	무선 인터넷 관련 기사	2
고평가된 주식과 저평가된 주식의 구분방법이 궁금해	고평가 주식 저평가 주식 구분 방법	2
가십란에 뭐가 나왔니	가십란 나온 것	2
소나기가 좋아	소나기 좋은지	0
다른 계좌 없어 자꾸 에러가 나네	다른 계좌 여부	0
김사장이 메일을 읽었니	김사장 메일 읽었는지	0
마이너스 통장은 이율도 일반 대출보다 비싸	마이너스 통장 이율 일반 대출보다 비싼지	0
무슨 집회 같은 걸 하나 	집회 여부	0
레저스포츠 관련 용품은 어디서 살 수 있는 거야 	레저스포츠 관련 용품 살 수 있는 곳	2
체크 인을 언제 하니	체크인 시간	2
이번에 우리 아기 보험을 하나 들려고 하는데 뭐가 좋아	좋은 아기 보험	2
간단히 할 수 있는 사업 뭐가 있지	간단히 할 수 있는 사업	2
서울 강남역 여행상품이 있니	서울 강남역 여행상품 	2
보고싶다 친구야 잘 지내지 	잘 지내는지	0
요번에 시험이 어려웠다던데 잘 봤어	시험 잘 봤는지	0
수락산 터널 차량 흐름은 어때	수락산 터널 차량 흐름	2
장외 주식이 상장되면 장내 주식으로 되나요 	장외 주식 상장 장내 주식 여부	0
이번 주 중에 인쇄는 마무리 된데요	이번 주 중 인쇄 마무리 되는지	0
우리 회사는 아넬바랑 기술 제휴 맺고 있는 거 맞죠	아넬바랑 기술 제휴 여부	0
좀 된 건가요	좀 된 건지	0
의사 선생님이 뭐라고 해	의사 선생님 한 말	2
시제이 홈쇼핑 전화번호는	시제이 홈쇼핑 전화번호	2
서울에서 라식수술 잘하는 안과는 어떻게 가냐	서울 라식수술 잘하는 안과 가는 방법	2
오늘 들어올 돈이 왜 아직 안 들어오는 걸까	들어올 돈 안 들어오는 이유	2
그러게 햇빛 차단제는 바르고 나왔어	햇빛 차단제 바르고 나왔는지	0
건강하게 잘 지내	잘 지내는지	0
한라산 원정대에서 백두산도 원정한데	한라산 원정대 백두산도 원정하는지	0
서울대 앞 냉면집 어떻게 가는가	서울대 앞 냉면집 가는 방법	2
서울에서 분위기가 제일 좋은 째즈바는 어디니	서울 분위기 좋은 째즈바	2
이번 총회의 안건은 무엇인가요	이번 총회 안건	2
눈이 너무 적게 와서 싫어	눈 너무 적게 와서 싫은지	0
아침식사를 안 하면 요금이 얼마니	아침식사 비포함 요금	2
경운기 운전해 보셨어요	경운기 운전 경험 여부	0
요즘 외국인들이 한국 주식을 파고 있는 이유가 뭘까 	요즘 외국인들 한국 주식 파는 이유	2
현재 경부 고속도로 날씨는 어떻지	현재 경부 고속도로 날씨	2
팔팔 고속도로 현재 상황은	팔팔 고속도로 현재 상황	2
주식을 하려면 은행에 가서 주식계좌를 만들어야 해	주식을 하려면 은행 가서 주식계좌를 만들어야 하는지	0
에스유브이와 알브이 중 어느 것이 더 경제적일까 	에스유브이 알브이 중 경제적인 것	2
직불카드를 잃어버렸는데 통장만으로 계좌이체가 된대 	통장만으로 계좌이체가 되는지	0
어제 과음한 것 같은데 속은 좀 어때 	속 괜찮은지	0
위안화 환전은 마쳤니	위안화 환전 마쳤는지	0
외환은행도 전화통화만으로 계좌 잔액 확인 가능해	외환은행 전화통화 계좌 잔액 확인 가능 여부	0
노량진의 바닷가재 요리 전문점은 어떻게 가	노량진 바닷가재 요리 전문점 가는 방법	2
주식의 공급은 어떤 방법으로 이뤄지나요	주식 공급 이루어지는 방법	2
그 내역에 대해 뭐라고 주장합니까 유죄입니까 무죄입니까 	그 내역 주장 유죄인지 무죄인지	1
여자친구 생겼다며 예뻐 	여자친구 예쁜지	0
날씨도 좋은데 오늘 뭐하니	오늘 하는 일	2
선물 옵션이 궁금 하네	선물 옵션	2
퇴근하고 나서 뭐 할 생각이야 	퇴근하고 할 것	2
공모주 펀드는 어떤 이점을 가지고 있나요	공모주 펀드 이점	2
내부 순환도로 사정이 좀 나아졌나	내부 순환도로 사정 나아졌는지	0
동서울 요금소 정체가 되고 있는지 알 수 있을까	동서울 요금소 정체 여부	0
민호 둘째 조카 돌잔치가 언제지	민호 둘째 조카 돌잔치 날짜	2
요즘 어떠세요	요즘 근황	2
교통사고 후유증 치료에 정형외과와 한의원 중 어디가 좋을까요	교통사원 후유증 치료 정형외과 한의원 중 좋은 곳	1
더위 먹었다며 괜찮은 거야	괜찮은지	0
체크 인 언제 하니	체크 인 시각	2
먹골의 배축제 기간은	먹골 배축제 기간	2
요가하면 몸매가 예뻐진데	요가하면 몸매 예뻐지는지	0
너 교양수업 리포트 제출했어 난 아직 쓰고 있는 중이야	교양수업 리포트 제출 여부	0
아르바이트 페이 받기로 한 날이 언제야	아르바이트 페이 받는 날	2
올해 우리 아버지 생신이 무슨 요일이냐	올해 우리 아버지 생신	2
장마철 산사태 발생 확률은	장마철 산사태 발생 확률	2
아이들은 건강하게 잘 크고 있니 	아이들 잘 크는지	0
뭐 먹으러 가죠 요즘은 식욕이 없어요	먹으러 갈 것	2
아시아 청소년 축구대회 한국 전적 관련 기사는 없을까	아시아 청소년 축구대회 한국 전적 관련 기사 여부	0
계좌이체 해줄까 아님 현금으로 줄까	계좌이체해줄지 현금으로 줄지	1
이 회사에서 근무한지 일주일 됐어	이 회사 근무한지 일주일 됐는지	0
이대 주변 컷트를 제일 잘하는 미용실은 어떻게 간데	이대 주변 컷트 잘하는 미용실 가는 방법	2
아직도 병원에 입원해있는 거야 	병원 입원 여부	2
이번 시험 어렵게 냈대	이번 시험 어렵게 냈다는지	0
이비인후과 가는 게 나을까 내과 가는 게 나을까 	이비인후과 내과 중 갈 곳	1
우리 형이 너 잘 지내고 있냐고 묻더라	잘 지내는지	0
요즘 넌 뭐하고 지내	근황	2
일월 삼십일이 세일 첫 날이야	일월 삼십일 세일 첫 날인지	0
그때 갔던 역삼동에 놀부부대찌게 왠지 다시가고싶지 않니	역삼동 놀부부대찌개 다시가고싶지 않은지	0
경원대학교 축제가 언제니	경원대학교 축제 시기	2
이 책에 나와 있는게 도움이 될까 	이 책 도움될지	0
너 예전에 다친 팔은 다 나았어	팔 다 나았는지	0
서울 전체에 막히는 구간의 현재상태는 어떨까	서울 전체 막히는 구간 현재상태	2
약속 시간은 언제냐	약속 시간	2
주식형 펀드 열풍이라는데 관심 있어 	주식형 펀드 관심 있는지	0
내일 저녁 한가하신지 알고 싶습니다	내일 저녁 한가한지	0
저녁 먹었어	저녁 먹었는지	0
음료수 포함인가요	음료수 포함 여부	0
태국과 필리핀 중 어느 상품이 더 저렴해	태국 필리필 중 상품 저렴한 곳	1
우리 회사 회식 이번 주 토요일인가	우리 회사 회식 이번 주 토요일인지	0
테마 주식에 열광하는 이유가 뭘까	테마 주식 열광 이유	2
시험 끝나고 뭐하고 놀까	시험 끝나고 놀 것	2
주식 휴면계좌를 살리려면 어떻게 해야 해 	주식 휴면계좌 살리는 방법	2
메이플 스토리에 관한 공지사항 있니	메이플 스토리에 관한 공지사항	2
아기 방에 가 있어	아기 방에 가 있는지	0
어젯밤 온 메일 중 첨부 파일 든 메일 얼마나 되냐	어젯밤 온 메일 중 첨부 파일 든 메일 수	2
서울대 근처 많이 가는 맥주집은 어떻게 갈까	서울대 근처 많이 가는 맥주집 가는 방법	2
우리회사 저번 회식일이 언제인데	우리회사 저번 회식일	2
눈에 멍이 들면 왜 계란으로 비비는 걸까 	눈 멍 계란 비비는 이유	2
이번 학기 총 몇 학점 들어 다 채웠어 	이번 학기 듣는 총 학점 수	2
비상장 주식일 경우에도 스탁옵션 행사가 가능할까요 	비상장 주식 스탁옵션 행사 가능 여부	0
홈쇼핑에서 보험을 계약하면 더 나을까	홈쇼핑 보험 계약이 더 나을지	0
동대문에서 제일 싼 술집 어떻게 가니	동대문 제일 싼 술집 가는 방법	2
오늘 모임에 참석할 건가요	오늘 모임 참석할지	0
주가가 많이 빠졌다는데 너는 어떠니 	주가 빠졌는지	0
과외 하니깐 성적 올라	과외 성적 많이 오르는지	0
인터넷 예금 종류는 어떤 종류가 있어 	인터넷 예금 종류	2
수리 업무는 어느 업체에 맡겨야 할까	수리 맡길 만한 업체	2
급해요	급한지	0
우리 할머니 제삿날이 언제이냐	우리 할머니 제삿날	2
고액권과 소액권 중 어느 것을 원하십니까	고액권 소액권 중 원하는 것	1
스톡옵션으로 사 놓은 주식이 있어	스톡옵션으로 사 놓은 주식 있는지	0
어젯밤 오후에 도착한 이메일은 몇 통이냐	어젯밤 오후 도착한 이메일 수	2
오늘 야구 삼성의 경기 관련 기사는 없을까	오늘 야구 삼성 경기 관련 기사 	2
뉴스에서 오늘 첫눈 온다고 했어	뉴스에서 오늘 첫눈 온다고 했는지	0
요즘 카드 어떤 게 좋아 혜택 많고 싼 거	요즘 혜택 많고 싼 카드	2
결혼기념일은 무슨 요일이니	결혼기념일 요일	2
종각역 서점은 어떻게가	종각역 서점 가는 방법	2
왜 아까 못들은 척 한거야	아까 못들은 척한 이유	2
지난주 전국 날씨가 어땠지	지난주 전국 날씨	2
갈수록 난위도가 높아져	갈수록 난위도가 높아지는지	0
수술 한 뒤로 몸은 좀 어떠세요	몸 괜찮은지	0
금요일 첫 수업이 뭐지	금요일 첫 수업	2
선배랑 언니랑 둘 중에 누가 먼저 와	선배 언니 중 먼저 오는 사람	1
영등포구 근처 일식집 어떻게 간데	영등포구 근처 일식집 가는 방법	2
오늘 사회면 주요 소식은 뭘까	오늘 사회면 주요 소식	2
예금담보 대출하려는데 어느 은행이 좋을까	예금담보 대출 좋은 은행	2
배 다쳤어	배 다쳤는지	0
생일선물 사기로 한 요일이	생일선물 사기로 한 요일	2
퇴근시간은 언제쯤인데	퇴근시간	2
인터넷으로 예금을 가입하면 좋은 점이 뭐야 	인터넷 예금 가입 장점	2
지영이랑 극장 가기로 한날이 언제지	지영이랑 극장 가기로 한날	2
주식 양도세에 관해서 알아보고 있어	주식 양도세	2
영수증 받기보다 현금영수증이 더 귀찮아	영수증 받기보다 현금영수증이 더 귀찮은지	0
출장 갈 때 뭐 타고 갈 거예요 	출장 갈 때 탈 것	2
뿌듯해	뿌듯한지	0
해외로 송금하려면 어떻게 해야 하지 	해외 송금 방법	2
경상도의 휴양림은	경상도 휴양림	2
그날 잘 들어가서 쉬셨나요 	그날 잘 쉬었는지	0
기획 특집 업무는 퀄리티가 떨어지나요 	기획 특집 업무 퀄리티가 떨어지는지	2
오늘은 음력으로 언제야	오늘 음력 날짜	2
김병현 선수의 기록에 대한 기사는 없을까	김병현 선수 기록 기사	2
빨리 풀리게 하는 방법 없니 	빨리 풀리게 하는 방법	2
베란다 꽃에 물을 줬나	베란다 꽃 물 줬는지	0
외국인 투자세로 들어섰다는 뉴스 봤어 	외국인 투자세 뉴스 봤는지	0
우산을 안 가져 왔는데 어쩌지	우산 안 가져 왔을 때 대책	2
너 대학국어 뭐 받았냐	대학국어 받은 것	2
보기 싫어	보기 싫은지	0
우리 누님 출산일이 언제야	누님 출산일	2
신촌에서 볼까 아니면 압구정에서 볼까	신촌에서 볼지 압구정에서 볼지	1
오늘 뉴스 속보 뭔데	오늘 뉴스 속보	2
육억 달러의 산출 근거가 뭐요 	육억 달러 산출 근거	2
케이 원이라는 것에 대한 기사 어떤 내용이지	케이 원 기사 내용	2
정문에서 종로 가려면 뭐 타야 돼	정문에서 종로 가려면 탈 것	2
크리스마스 행사가 몇 시부터 있지	크리스마스 행사 시작 시각	2
괜찮아	괜찮은지	0
워크샵 간다는데 가기 싫어 어떡해 하면 빠질까 	워크샵 빠질 방법	2
이천 사년 유로 월드컵의 우승 팀에 대한 기사 어떤 내용이지	이천 사년 월드컴 우승 팀 기사 내용	2
오늘 에스케이정유 하한가가 얼마니	오늘 에스케이정유 하한가	2
그럼 잘되려면 무엇부터 해야 하죠	잘되려면 먼저 할것	2
주간 회의록은 누구한테 결재 맡으면 되죠	주간 회의록 결재 맡을 사람	2
이번 학기에 수업 뭐 들어	이번 학기 수업	2
어떤 예금이 이자율이 높나요	이자율이 높은 예금	2
우리 같이 중국 다녀 온 게 몇 년 전이지	우리 같이 중국 다녀온 시기	2
이번에 결혼한다던데 며칠이야 	결혼 날짜	2
홍은동 녹번역 구간 교통상황 어떻데	홍은동 녹번역 구간 교통상황	2
참 제수씨는 안녕하신가 	제수씨 안녕하신지	0
수요일에 친구 선물 사러 백화점 같이 갈까	수요일 친구 선물 사러 백화점 같이 갈지	0
고깃집 요즘 장사 잘돼	고깃집 요즘 장사 잘되는지	0
도대체 언제쯤 부모님께 나를 알려드릴 거니 	부모님께 나를 알려드릴 시기	2
회계원리는 그 친구가 제일 잘 알아	회계원리 그 친구가 제일 잘 아는지	0
주택청약이랑 주택부금이 뭐가 달라	주택청약 주택부금 차이점	2
정말 하기 싫어	정말 하기 싫은지	0
내가 자동차 엔진오일 넣은 날은 언제지	내가 자동차 엔진오일 넣은 날짜	2
서울대 앞 중국집은 어떻게 가니	서울대 앞 중국집 가는 방법	2
요가는 삼개월 정도 해야 효과를 볼 수 있데	요가 삼개월 정도 해야 효과 볼 수 있는지	0
대리운전 불러	대리운전 부를지	0
바퀴가 자꾸 미끄러지는데 어떡하지	바퀴 자꾸 미끄러지는 상황 대책	2
전학 가서 외롭지는 않아	외롭지는 않은지	0
빨래는 추운 날씨와 더운 날씨 중 어느 때 더 잘 마를까 	빨래 추운날씨 더운날씨 중 더 잘 마를 때	1
점심은 뭐 먹었어 매일 똑같은 거 먹기 지겹지 	점심 먹은 것	2
안녕하세요	안녕한지	0
정신적 건강과 육체적 건강은 무슨 차이가 있나요 	정신적 건강 육체적 건강 차이	2
마티니요 그게 무슨 뜻이에요	마티니 의미	2
무역회사에서 주로 하는 업무는 무엇입니까	무역회사 주 업무	2
주말 공연은 이미 매진이야 평일은 볼 수 있을까	평일 공연 가능 여부	0
후유증은 없니 	후유증 여부	0
그러면 네가 너무 오래 기다릴텐데 괜챦겠어 	오래 기다리는 것 괜찮은지	0
술 먹었어	술 먹었는지	0
광주의 특산품은 뭐니	광주 특산품	2
제 사이즈로 있나요	제 사이즈 잇는지	0
기분 나쁘지 않아	기분 나쁘지 않은지	0
인터넷쇼핑이 경제적이야	인터넷쇼핑 경제적인지	0
사월 삼일부터 휴가야	사월 삼일부터 휴가인지	0
방 열쇠가 어디 있는지 모르겠다	방 열쇠 위치	2
어제는 팔굽혀펴기를 했어	어제 팔굽혀펴기 했는지	0
두기업중 어느 기업의 주식을 살까요	주식 살 기업	2
진영이랑 같이 병문안 가려고 하는데 몇 호실로 찾으면 되니	병문안 호실	2
토큰은 어디서 파나요	토큰 파는 곳	2
밴드랑 소독약 있나요	밴드 소독약 여부	0
버스와 전철 중 이용량이 더 많은 것은 무엇일까 	버스 전철 중 이용량 더 많은 것	1
내일 회식해도 관계없어	내일 회식 괜찮은지	0
문자 하지	문자 하는지	0
태풍 때문에 발생한 피해 복구에는 얼마나 걸릴까 	태풍  피해 복구 걸리는 시간	2
뉴욕 지사에서 근무하게 된 기분이 어때 	뉴욕 지사 근무 소감	2
약속하셨나요	약속 여부	0
입금 취소 하고 싶은데 방법을 알고 있니 	입금 취소 방법	2
병원에 입원했다며 	입원 여부	0
서울 천안 간 소통은 원활하니	서울 천안 간 소통 원활 여부	0
소나기가 좋아	소나기가 좋은지	0
오늘 정치 이슈는 무엇이야	오늘 정치 이슈	2
오빠 잘 지내고 계시는지요 	잘 지내는지	0
그 뒤에 특수차량으로 이송하는 사이에 탈취해야 하겠죠	특수차량으로 이송하는 사이 탈취해야 할지	0
기획 영업팀의 성격과 하는일이 궁금해요	기획 영업팀 성격 업무	2
적금이랑 예금 중에서 어떤 게 더 나을까	적금 예금 중 나은 것	1
왜 걔한테 불똥이 튀었어	불똥 튄 이유	2
부산대학병원에서 제일 가까운 약국은 어디일까	부산대학병원 제일 가까운 약국	2
냄비를 빌려도 될까요	냄비 빌려도 될지	0
유레일 패스로 갈 수 있는 나라는 어디야	유레일 패스로 갈 수 있는 나라	2
등록금 납부 학교 코드를 잊어버렸는데 혹시 너 알아	등록금 납부 학교 코드	2
여기서 기다릴까	여기서 기다릴지	0
기획관리팀에서 지은씨만 대리 못 달았대	기획관리팀에서 지은씨만 대리 못 달았는지	0
쥬디스 태화는 어디일까	쥬디스 태화 위치	2
식사를 너무 빨리하면 안 좋데	식사 너무 빨리하면 안 좋은지	0
워커힐에 남편도 와있어요	워커힐 남편 와있는지	0
오늘 새 편지 몇 통 왔어	오늘 새 편지 수	2
삼성전자가 유망하다는데 주식을 살까	삼성전자 주식 살지	0
오늘 오전에 온 새 편지 몇 통이니	오늘 오전 온 새 편지 수	2
건대 부근 서점은 어디	건대 부근 서점 위치	2
서초구 서초동 근처 고깃집 어디에 있데	서초구 서초동 근처 고깃집 위치	2
몸은 어떠세요 많이 나아지셨는지 궁금하네요	몸 많이 나아졌는지	0
현관문 자물쇠 보여	현관문 자물쇠 보이는지	0
은행 예금을 해지하려고 하는데 어디로 가야 하는가요 	은행 예금 해지할 곳	2
우리 민호 예방접종 하려고	민호 예방접종 하는지	0
주차장 이야	주차장인지	0
교육과정사회학 청강할려고 하는데 괜찮을까요	교육과정사회학 청강 괜찮을지	0
외할아버지 칠순잔치가 언제야	외할아버지 칠순잔치 날짜	2
경부 고속도로 정체구간은 얼마나 되냐	경부 고속도로 정체구간 정도	2
우리 회사 계열사에서 분리 됐어	우리 회사 계열사에서 분리 됐는지	0
서울에서 가장 분위기 좋은 재즈 바는 어디일까	서울 분위기 좋은 재즈 바	2
명륜동의 시싯골에서 연산동 올림피아 볼링장 구간 도로상황은 어떻니	명륜동 시실골에서 연산동 올림피아 볼링장 구간 도로상황	2
손가락 다쳤어	손가락 다쳤는지	0
왜 모두 은행에 다니면 이자부터 묻는 걸까 	은행 다니면 이자부터 묻는 이유	2
면허 취득 기준은 무엇인가요	면허 취득 기준	2
지금 임시보관함에 보관된 메일이 모두 몇 통이야	지금 임시보관함 보관 메일 수	2
여객선은 하루에 몇 대 있지	하루 여객선 수	2
고등학교의 졸업식이 언제냐	고등학교 졸업식	2
요리 같은 거 국비로 공부 할 수 있는 곳 없어  	국비로 요리 공부 가능한 곳	2
이 카드 외국에서도 쓸 수 있는 거야 	이 카드 외국에서도 쓸 수 있는지	0
회원은 많이 모집 하셨나요	회원 모집 많이 했는지	0
운임이 얼마인가요	운임	2
위탁모집은 뭘 말하는 거야 	위탁모집 의미	2
넌 지금 어느 역 지나고 있어	지금 지나는 역	2
우리 타임캡슐 만들어요	타임캡슐 만들지	0
이번에 교양과목 뭐 들어 	이번 듣는 교양과목	2
인터넷 예금 종류는 어떤 종류가 있어 	인터넷 예금 종류	2
가계의 주식투자 결정요인은 무엇인가 	가계 주식투자 결정요인	2
주위에 인라인 스케이트 탈만한 곳이 있을까 	주위 인라인 스케이트 탈만한 곳	2
수표 입금 시 뒷면에 이서를 해야 하나요 	수표 입금 시 뒷면 이서 여부	0
뭐 먹을 거야	먹을 것	2
괜찮아	괜찮은지	0
시험 잘 봤니	시험 잘 봤는지	0
위탁잔고증명서 봤어	위탁잔고증명서 봤는지	0
내려 오는 것 몇 시야	내려오는 시각	2
옳지 않다고 생각해	옳지 않다 생각하는지	0
냉장고에 와인 있어	냉장고 와인 있는지	0
충격으로 쓰러 지셨데	충격으로 쓰러 지셨는지	0
담배보다 술이 정말 끊기가 어려워	담배보다 술 끊기 어려운지	0
택시를 타는 것이 빠를까 지하철을 타는 것이 빠를까	택시 지하철 중 빠른 것	1
사람들은 왜 주식을 사는 것일까 	사람들 주식 사는 이유	2
오늘 만나서 뭐 할래	오늘 만나 할 것	2
오늘 메일 중 첨부 파일이 든 메일 몇 통이지	오늘 메일 중 첨부 파일 든 메일 수	2
다음 학기 시간표 짰어 	다음 학기 시간표 짰는지	0
그거 예금통장으로 넣으면 되	그거 예금통장으로 넣으면 되는지	0
학교에서 셔틀버스 타면돼	학교에서 셔틀버스 타면 되는지	0
조만간 한번 볼까	조만간 한번 볼지	0
정말이지	정말인지	0
오늘의 습도가 얼마였지	오늘 습도	2
콜벤 한 대 불러서 이사하는게 더 편하고 싸	콜벤 한 대 불러 이사하는게 더 편하고 싼지	0
오늘 방화 관련 기사가 뭐니	오늘 방화 관련 기사	2
잘 지내냐	잘 지내는지	0
직원 할인 요금 있니	직원 할인 요금 여부	0
샐러드나 소스는 어떠세요	샐러드 소스 어떤지	0
전 은행의 현금 서비스 연체 이자는 얼마쯤 되나요 	전 은행 현금 서비스 연체 이자	2
인쇄 맡긴 거 내일까지 배달해 준데	인쇄 맡긴 거 내일까지 배달해 주는지	0
걷는 게 유산소 운동이래	걷는 게 유산소 운동인지	0
근처에 조깅 코스도 다 마련돼 있어	근처 조깅 코스 여부	0
현재 원효대교 북단 교통 원활할까	현재 원효대교 북단 교통 원활 여부	0
우리애도 교육보험 하나 들어야 할 거 같은데 뭐가 좋아요	들기 좋은 교육보험	2
서울에 언제 도착해	서울 도착 시각	2
수영하면 살 많이 빠져	수영 살 많이 빠지는지	0
봄에 왜 코스코스가 피는 거야 	봄 코스코스 피는 이유	2
아까 주차위반 딱지 뗐어	아까 주차위반 딱지 뗐는지	0
칠 호선 갈아타려면 맨 뒤쪽에서 타는 게 더 편해	칠 호선 갈아타려면 맨 뒤쪽에서 타는 게 더 편한지	0
버스와 지하철 중에서 뭘 이용할 거니 	버스 지하철 중 이용할 것	1
무슨 역이야	현재 역	2
내일 오후 올라가는 열차 예약해	내일 오후 올라가는 열차 예약하는지	0
주식시장의 불법행위는 어떠한 것들이 있나요 	주식시장 불법행위	2
그 카드에는 어떤 할인혜택이 있는데 	그 카드 할인 혜택	2
지금 경부선 고속도로에서 가장 막히는 구간은 어디니	지금 경부선 고속도로 가장 막히는 구간	2
회신 이메일 모두 몇 통이나되지	회신 이메일 수	2
저희 어머니가 저의 이름으로 정기예탁을 드셨어요 	어머니가 저의 이름으로 정기예탁 드셨는지	0
어머니 몇 시에 약 드셨어	어머니 약 드신 시각	2
잠실대교 상황을 알 수 있을까	잠실대교 상황	2
스키 못타는데 가면 알려주는 거야	스키 타는 법 알려주는지	0
오늘 새 편지 몇 통 왔냐	오늘 온 새 편지 수	2
한글과컴퓨터 주를 살까 말까	한글과컴퓨터 주식 살지	0
적금을 해약할까 마이너스 통장이 될까	적금 해약할지 마이너스 통장이 될지	1
서울에서 분위기가 제일 좋은 스카이 라운지의 위치는 어디냐	서울 분위기 제일 좋은 스카이 라운지 위치	2
부도 나서 회사가 휘청거린다는데 그만둬야 하나 	회사 그만둬야 하는지	0
그쪽은 눈 많이 와요 이쪽은 완전 천국이에요	눈 많이 오는지	0
외국인 보유주식의 시가총액이 얼마나 되는지요	외국인 보유주식 시가총액	2
막내의 졸업식은 언제지	막내 졸업식	2
너 오늘 내 친구들이랑 두 시에 점심 약속 있어	오늘 내 친구들과 두 시 점심 약속 여부	0
오늘 오후에 정순이와 약속이 몇 시지	오후 정순이 약속 시각	2
다음 주 수요일에 찜질방이나 갈까	다음 주 수요일 찜질방 갈지	0
규형아 오늘 과외 선생님이 못 오신데	오늘 과외 여부	0
이태원 근처 일식 전문점은 어디래	이태원 근처 일식 전문점	2
잘 들어갔어요	잘 들어갔는지	0
암기능력 향상하는 방법이 없을까	암기능력 향상 방법	2
기말고사 시험범위 알어	기말고사 시험범위	0
물이 안좋아	물이 안좋은지	0
종로랑 신천 중 어디 갈까	종로 신천 중 갈 곳	1
뉴스에서 오늘 첫눈 온다고 했어	뉴스에서 오늘 첫눈 온다고 했는지	0
광앙리에서 연인들이 제일 많이 가는 레스토랑은 어디야	광앙리 연인들 제일 많이 가는 레스토랑	2
이번에 씨이오가 바뀐다던데 누가 될까 	이번 씨이오	2
장애인 올림픽 결과 관련 기사는 없을까	장애인 올림픽 결과 관련 기사 여부	0
오늘 발표 준비는 잘해왔어	발표 준비 잘 해왔는지	0
설날 연휴 잘 보내셨나요 	설날 연휴 잘 보냈는지	0
다들 그래	다들 그런지	0
이번 야유회도 가족동반 인가요	야유회 가족동반 여부	0
너 왜 오늘도 수업 빠진 거야 	수업 빠진 이유	2
의료보험 카드없어도 돼	의료보험 카드 필요 여부	0
어제 농구결과 어떻게 됐냐	어제 농구결과	2
다음주에 눈이 얼마나 올까	다음주 눈 예상 양	2
현금카드 재발급 수수료 비싸냐	현금카드 재발급 수수료 비싼지	0
서울에서 치료를 잘하는 안과는 어디니	서울 치료 잘하는 안과	2
학교 합격 했다고 	학교 합격 했는지	0
우리 과장님하고 싸웠어	우리 과장님하고 싸웠는지	0
주식에는 손대지 않는 것이 낫다고들 하는데 왜 그런거죠	주식 손대지 않는 것이 나은 이유	2
차 고장 났어	차 고장 났는지	0
밖이 어두워 졌니	밖이 어두운지	0
실시간으로 내 주식의 등락폭을 알 수 있는 방법은 뭘까요	실시간 주식 등락폭 알 수 있는 방법	2
계획하신 일 준비는 잘 되갑니까 	계획한 일 준비 잘 되가는지	0
마라톤 하려고	마라톤 할지	0
얼굴이 야윈 듯 한 게 아파보이네 어디 안 좋아 	몸 상태	2
사업계획서는 다 작성했니 	사업계획서 작성 여부	0
이번에 차량을 바꾸려고 하는데 소나타가 낳을까 아님 투스카니가 낳을까 어차피 이천 씨씨 탈 거니까	소나타 투스카니 중 나은 것	1
고깃집에서 만나는 거냐 횟집에서 만나는 거냐 	고깃집 횟집 중 만나는 곳	2
내일 비가 내릴 확률은 얼마야	내일 비 내릴 확률	2
현재 황사 경보가 내려진 지역이 어디지	현재 황사 경보 내려진 지역	2
예금담보 대출하려는데 어느 은행이 좋을까	예금담보 대출에 좋은 은행	2
추진 중이래	추진 중인지	0
이번 주 토요일에 만나기로 한 사람이 누구지	이번 주 토요일 만나기로 한 사람	2
폐장하기 전에 또 한 번 갈까	폐장 전에 또 갈지	0
명일동 명성교회는 어디에 있냐	명일동 명성교회 위치	2
고속도로에서 운전하는 게 더 쉬워	고속도로 운전 더 쉬운지	0
내일 자외선 지수가 어떻게 되지	내일 자외선 지수	2
사모님과 여행 잘 다녀 오셨나요	사모님과 여행 잘 다녀왔는지	0
압구정동에서 쌍꺼풀 수술 잘하는 성형외과는 어떻게 가니	압구정동 쌍꺼풀 수술 잘하는 정형외과 가는 방법	2
하이닉스 요즘 주가는 얼만데	하이닉스 요즘 주가	2
요즘 특별히 힘든 일은 없고 	요즘 특별히 힘든 일 없는지	0
천만 원정도 여윳돈 생겼는데 주식 어떨까	주식 어떨지	2
현재 안락동 도로 상황은 괜찮니	현재 안락동 도로 상황	2
파워포인트로 발표 하게	파워포인트로 발표할지	0
곗돈 타서 그걸로 은행 대출금 갚았어	곗돈 타서 은행 대출금 갚았는지	0
책상에 컨닝 하려고 썼는데 걸리면 안돼 	책상 컨닝 걸리면 안되는지	0
요금 얼마니	요금	2
지난번 배운 곳 요점정리 해봤어	지난번 배운 곳 요점정리 해봤는지	0
공원에 가려면 버스와 지하철 어느 것이 편리하니 	버스 지하철 중 공원 가려면 편리한 것	2
침대는 싱글로 예약해	침대 싱글 예약할지	0
구리에 있는 일식 전문점 어떻게 갈까	구리 일식 전문점 가는 방법	2
주요 촬영지 변경됐어	주요 촬영지 변경 여부	0
너를 만난 시간은 내게 큰 행복이야 열심히 살고 있지	열심히 살고 있는지	0
친절한 금자씨 개봉일이 언제야	친절한 금자씨 개봉일	2
얼마나 머무실 건가요	머무는 기간	2
현재 중부 하행선 교통이 통제되는 구간은 어떨지	현재 중부 하행선 교통 통제 구간 상황	2
현관에 누구냐	현관 사람	2
어젯밤 도착한 이메일 몇 통이나 된데	어젯밤 도착 이메일 수	2
나 가도 돼	나 가도 되는지	0
고양이 예방접종일이 언제지	고양이 예방접종일	2
오늘 표정이 어둡던데 무슨 일 있어 	무슨 일 있는지	2
경주에는 특산품 점이 많을까	경주 특산품 점 많은지	0
둘째 누나 결혼식이 언제야	둘째 누나 결혼식 시기	2
동대문에서 저렴한 맥주집은 어디일까	동대문 저렴한 맥주집	2
한겨울에 그렇게 얇게 입고 나와서 괜찮겠니 	얇게 입고 괜찮은지	0
학교에 가고 있어	학교 가고 있는지	0
지금이 팔 시기일까 살 시기일까	지금이 팔 시기일지 살 시기일지	1
기다리지마	기다리지 말지	0
오늘 강수량이 얼마나 되지	오늘 강수량	2
오늘 주식시장의 주요 소식 뭘까	오늘 주식시장 주요 소식	2
정체 구간이 몇 곳이나 되지	정체 구간 수	2
수학 과외하면 성적 올릴 수 있을까	수학 과외 성적 오르는지	0
서울 방배동에 우리은행 지점은 어떻게 가	서울 방배동 우리은행 가는 방법	2
안개는 액체일까 기체일까	안개 액체인지 기체인지	1
준영이랑 효진이랑 사귄데	준영 효진 사귀는지	0
차 바퀴엔 체인 감았냐 온통 빙판이던데 	차 바퀴 체인 감았는지	0
방학기간이 얼마나 되지	방학기간	2
다음 주 화요일에 우리 보기로 한 거 맞지	다음 주 화요일 보는지	0
이번 승진 발표 언제 난데 	이번 승진 발표 시기	2
배 안아파	배 안아픈지	0
우리나라 황금사원은 어디에 있냐	우리나라 황금사원 위치	2
공지사항 인터넷에다 띄웠어	공지사항 인터넷에다 띄웠는지	0
학교 도서관 몇 권까지 대출 가능하지	학교 도서관 대출 한도	2
금방 도착해	금방 도착하는지	0
점심은	점심 먹었는지	0
체크 아웃이 언제니	체크 아웃 시각	2
박물관 전체 관광 소요시간은	박물관 전체 관광 소요시간	2
학교에서 간염 검사 한대	학교 간염 검사 하는지	0
이월 칠일이 토익 시험 날이야	이월 칠일 토익 시험 날인지	0
명일동 근처 한식 전문점은 어디지	명일동 근처 한식 전문점	2
인터넷 쇼핑한거 입금해야 돼	인터넷 쇼핑한거 입금해야 되는지	0
오늘 탄핵 결과가 어찌됐니	오늘 탄핵 결과	2
공개방송이면 연예인들 나오는 거 	연예인들 나오는지	0
흐린 날씨래요	흐린 날씨인지	0
내일 수업 정확히 몇 시에 끝나	내일 수업 끝나는 시각	2
현재 중부 상행선에서 교통이 통제되는 구간은 어디냐	현재 중부 상행선 교통 통제 구간	2
오늘 서울 지역 구름 양은 어떤가	오늘 서울 지역 구름 양	2
하동에서 횡천까지의 길이 어떤데	하동에서 횡천까지 길 상황	2
우리나라는 성인이 돼야 마음대로 사업을 할 수 있나요 	우리나라 성인만 사업할 수 있는지	0
몇 시부터 할 수 있죠	시작 가능 시각	2
평소와 다르게 피곤해 보이는데 웬일인가요	피곤해 보이는 이유	2
약속한 장소는 어디일까	약속한 장소	2
해운대 시장에서 소문난 맛집은 어디	해운대 시장 소문난 맛집	2
제목에 결제라고 들어간 이메일이 몇 개지	제목 결제 들어간 이메일 수	2
전화 벨소리 못 들었어 샤워했어	샤워했는지	0
지하철 요즘도 위험하니	지하철 요즘도 위험한지	0
오늘은 안개가 낄까	오늘 안개 여부	0
싱가폴 출장 일정이 어떻지	싱가폴 출장 일정	2
지금 경부 고속도로의 교통상황은 어때	지금 경부 고속도로 교통상황	2
다리에 쥐가 나서 고통스러운데 빨리 풀리게 하는 방법 없니 	쥐 빨리 풀리는 방법	2
개천절날 날씨가 어떻지	개천절 날씨	2
오늘 부산에도 눈이 내리니	오늘 부산 눈 내리는지	0
이 사인은 왜 하는 거에요	사인 이유	2
인터넷 쇼핑몰 할 만한 아이템이 뭐가 있을까 	인터넷 쇼핑몰 할 만한 아이템	2
언제 뵐까요 여섯시 어때요	볼 시간	2
정기적금과 자유 적금 중 추천해주고 싶은 것은 뭐야	정기적금 자유적금 중 추천해주고 싶은 것	1
서울대 인근 당구장 어떻게 가는가	서울대 인근 당구장 가는 방법	2
롯데백화점까지 이십분이면 도착할 것 같아	롯데백화점까지 이십분이면 도착하는지	0
펜션 예약이 되어있나	펜션 예약 여부	0
경부 고속도로 내 소통 원활한 구간 어디니	경부 고속도로 내 소통 원활한 구간 위치	2
운동 시작한다더니 뭐 하기로 했어  	시작한 운동	2
경제면 주요 기사는 뭐니	경제면 주요 기사	2
건강상의 이유로 사표 냈데	건강상 이유로 사표 냈는지	0
종로 교차로 상황은 어때	종로 교차로 상황	2
요가보단 필라테스가 더 효과적이야	요가보단 필라테스  효과적인지	0
그럼 우리의 약속은 다 없어진 거니 	약속 없어졌는지	0
내가 갖고 있는 주식의 현재가치를 알고 싶습니다	내가 가진 주식 현재가치	2
지하철 근처에 쇼핑몰 생겼어	지하철 근처 쇼핑몰 생겼는지	0
내일이 로또방송 하는 날인가	내일 로또방송 날인지	0
오늘 늦어	오늘 늦는지	0
이상해	이상한지	0
직장 분위기는 괜찮아	직장 분위기 괜찮은지	0
강남역 주변의 예식장은	강남역 주변 예식장	2
수유에서 여의도 가려면 어디서 환승해야 하지 	수유에서 여의도 가려면 환승 위치	2
해외 증시 알아볼 만한 사이트가 어디 있을까	해외 증시 알아볼 만한 사이트	2
이번 여행은 꽤 길어졌는데 음식은 입에 맞나요 	음식 입에 맞는지	0
이 돈으로 사업을 시작해 볼까 재테크를 할까	이 돈으로 사업 시작할지 재테크할지	1
강남구청 가려면 버스와 지하철 중 어느 쪽이 더 나은가요	강남구청 가려면 버스 지하철 중 나은 것	1
올 크리스마스에 눈이 올까	올 크리스마스 눈 올지	0
통장 어느 은행에서 만들었어	통장 만든 은행	2
실업급여 타는 방법이 뭐야 	실업급여 타는 방법	2
명동 부근 카레 전문점 어디에 있어	명동 부근 카페 전문점 위치	2
막내가 태어난 해가 언제야	막내 태어난 해	2
학습지는 뭐가 좋지요	좋은 학습지	2
상견례에서 얘기 잘 됐어	상견례에서 얘기 잘 됐는지	0
막내의 면접시험 날짜는	막내의 면접시험 날짜	2
그거 왜 안 팔고 가지고 있어	안 파는 이유	2
이틀이요	이틀인지	0
이번에 워크샵에 참가할 생각이야	워크샵 참가 여부	0
왜 약속 시간에 늦지 말아야 하는거야 	약속 시간에 늦지 말아야 하는 이유	2
일반정육점과 비교해 가격이 어떻죠	일반정육점 비교 가격	2
삼성 카드랑 현대 카드 중에 어느 게 더 나을까	삼성 카드 현대 카드 중 나은 것	1
지방은 버스요금 얼마야 	지방 버스요금	2
참 이번 주 일요일 날 우리 오빠가 술 산다고 하는데 올래	일요일 날 오는지	0
오늘 돈 찾으면 수수료 내야 되는 거야	오늘 돈 찾으면 수수료 내야 되는지	0
잘 들어갔어요	잘 들어갔는지	0
열시 십분에 비디오 녹화하니	열시 십분 비디오 녹화 여부	0
아이들은 잘 크고 있겠지 	아이들 잘 크고 있을지	0
수요일 첫 수업이 뭐지	수요일 첫 수업	2
거기 좀 이상해 	거기 좀 이상한지	0
비디오 테이프를 디브이디로 변환하니	비디오테이프 디브이디 변환 여부	0
국어시험 범위가 어디까지야 	국어시험 범위	2
기름 경고등 불 켜지고 나서 얼마나 탈수 있지	기름 경고등 후 가능 시간	2
위탁 증권이면 난 아무 것도 안 해도 되는 거야	아무 것도 안 해도 되는지	0
지금 경부 고속도로의 교통상황은 어떻게 될까	지금 경부 고속도로 교통상황	2
강남역 근처 게임방은 어디더라	강남역 근처 게임방 위치	2
언제가 시간이 제일 편하세요	제일 편한 시간	2
어딨지	위치	2
천만 원정도 여윳돈 생겼는데 주식 어떨까	천만 원 주식 어떨지	0
부산 시내 지체구간 어디니	부산 시내 지체구간 위치	2
현금으로 드릴까요 아님 통장으로 입금해 드릴까요	현금 줄지 통장 입금할지	1
꼭 좌석표 지참해야 해	좌석표 지참 필수 여부	0
내일 사업 설명회 때 어떤 내용을 말하지 	내일 사업 설명회 말할 내용	2
내일 우리집에 누가 오기로 했었나	내일 우리집 누가 오는지	0
예약해 놨어	예약해 놨는지	0
오늘 뉴욕 메츠에 대한 소식이 있니	뉴욕 메츠 소식	2
전문가들은 왜 안 사나요	전문가들 안 사는 이유	2
방은 싱글 예약해	방은 싱글 예약할지	0
참 이번 주 일요일 날 우리 오빠가 술 산다고 하는데 올래	이번 주 일요일 날 술 마실지	0
오늘은 야식 안 먹는데	오늘 야식 안 먹는지	0
조성민 선수의 현황은 어때	조성민 선수 근황	2
장기투자 하려고 갖고 있는 주식인데 계속 보유하는 편이 나을까요 	계속 주식 보유할지	0
목 아프면 이비인후과 가야 돼	목 아프면 이비인후과 가야 되는지	0
삼성동 주변 일식집은 어디지	삼성동 주변 일식집 위치	2
북쪽으로 빠질까	북쪽 빠질지	0
세계 여행을 할 때 나라들의 인사법을 알아야 하나 	세계 여행 나라별 인사법 알아야 하는지	0
이 메일 학교 친구 그룹에 모두 보내	이 메일 학교 친구 그룹에 모두 보내는지	0
행복해	행복한지	0
몇 시에	시각	2
정확히 몇 시에 끝나는 거야	끝나는 시각	2
인터넷 뱅킹으로 보냈어 왜 안 갔어 	인터넷 뱅킹으로 갔는지	0
수리 영역 교육 방송 시간이 언제지	수리 영역 교육 방송 시간	2
경부 고속도로에 노면 결빙 구간 어디래	경부 고속도로 노면 결빙 구간 위치	2
동휘 환송회 해줬으면 좋겠는데 네 생각은 어때	동휘 환송회 어떤지	0
현재 중부 고속도로의 노면 상태는 어떻지	현재 중부 고속도로 노면 상태	2
류인 추모전 내일까지 밖에 안한대	류인 추모전 내일까지인지	0
장미 공원 가고 싶지	장미 공원 가고 싶은지	0
너 지표 분석 할 줄 아니	지표 분석 가능 여부	0
대학 평점은 좋은 편이니 	대학 평점 좋은지	0
서울대학교 앞 학생들이 많이 가는 노래방은 어떻게 갈까	서울대학교 앞 학생들이 많이 가는 노래방 가는 방법	2
오늘 결재일 이야	오늘 결재일인지	0
수업 자료는 얼마나 준비되었니	수업 자료 준비 상황	2
분당 근처 노래방 어딘데	분당 근처 노래방 위치	2
팔월 말 전국 날씨 어떨까	팔월 말 전국 날씨	2
롯데 백화점 가을 정기 세일 기간이 언제니	롯데 백화점 가을 정기 세일 기간	2
현대백화점에서 살 것도 많아	현대백화점에서 살 것 많은지	0
나쁘진 않아	나쁘진 않은지	0
코미디 물인가요	코미디물 여부	0
최신형 휴대폰을 단돈 삼만 원에 팔고 있어	최신형 휴대폰 삼만 원에 파는지	0
대리운전 불러	대리운전 부를지	0
운전 중이야	운전 중인지	0
용산에 위치한 태국요리 전문점 어떻게 가냐	용산 태국요리 전문점 가는 방법	2
신촌에서 다섯 시쯤에 만날까	신촌 다섯 시쯤 만날지	0
내일 오전에 만날 사람 있어	내일 오전에 만날 사람 있는지	0
오늘의 금리 어떻게 되냐	오늘 금리	2
짐 제한 무게 얼마냐	짐 제한 무게	2
지하철 앞쪽이야 뒤쪽이야 	지하철 앞쪽인지 뒤쪽인지	1
보드랑 스키 중에서 뭐가 더 빨리 배울 수 있어	보드 스키 중 더 빨리 배울 수 있는 것	1
인사동에 있는 사우나는 어디야	인사동 사우나 위치	2
토익보다 텝스가 어렵대	토익보다 텝스가 어려운지	0
워킹비자로 장사할 수 있나요 	워킹비자 장사 가능 여부	0
예금담보 대출하려는데 어느 은행이 좋을까	예금담보 대출 좋은 은행	2
길동 근처의 길동사거리 정체되나	길동 근처 길동사거리 정체 여부	0
내년에는 주가지수가 오를까 	내년 주가지수가 오를지	0
지금 지하철 플랫폼에 서있어	지금 지하철 플랫폼에 서있는지	0
그 영화 보지마	그 영화 볼지	0
작가들과 원고가 약속되어 있어요	작가들과 원고 약속되어 있는지	0
생각 중이야	생각 중인지	0
대문이 잠겨 있니	대문 잠겨 있는지	0
이백삼십사 호실을 찾고 있는데요 어떻게 가야 하나요	이백삼십사 호실 가는 방법	2
서울대 앞 우동 전문점은 어디지	서울대 앞 우동 전문점	2
전국의 놀이공원 어디냐	전국 놀이공원 위치	2
국가대표 축구 경기 어땠니	국가대표 축구 경기 소감	2
이번 헬스클럽 회원 만료일이 언제냐	이번 헬스클럽 회원 만료일	2
회사 컴퓨터 싹 바꿨음	회사 컴퓨터 싹 바꿨는지	0
스위스 은행에 계좌가 있다구	스위스 은행 계좌 여부	0
여기 고속도로야	여기 고속도로인지	0
행정법 김정일과 성봉근이 대세인 듯 둘 중에 누가 더 좋아	행정법 김정일 성봉근 중 나은 것	1
전화도 안받는데 만나지마	만나지 말지	0
과연 올해 안에 천이백선 도달할 수 있을까 	올해 천이백선 도달 가능 여부	0
비행기표 미리 구해 놨어 	비행기표 미리 구해 놨는지	0
정기예금이랑 적금이랑 틀린 거야 	정기예금 적금 다른지	0
거기까지 한번에 가는 버스 없냐 	거기까지 한번에 가는 버스 여부	0
기타를 쳐요	기타를 치는지	0
오늘 수표 넣으면 내일부터 쓸 수 있어요	오늘 수표 넣으면 내일부터 쓸 수 있는지	0
건강을 유지할려면 어떤 방법이 좋을까요	건강 유지 방법	2
해외 여행 때는 카드를 사용하는 게 좋아	해외 여행 카드 사용이 좋은지	0
우리 목욕탕 언제 고고하지	목욕탕 갈 시기	2
나 호주로 유학 가려고 하는데 준비할 게 뭐가 있을까	호주 유학 준비할 것	2
서울역 근처의 중국집은 어디래	서울역 근처 중국집	2
명절 때 내려갈 차표 미리 예매해 뒀어 	명절 차표 예매해 뒀는지	0
정말이야	정말인지	0
친구야 요번 시험 잘 봤니 	요번 시험 잘 봤는지	0
은정이와 에버랜드 가기로 한 날이 언제지	은정이와 에버랜드 가기로 한 날	2
내일 서류 가지러 사무실에 갈게 몇 시쯤 	사무실 갈 시각	2
스쿼시는 헬스가 무료야	스쿼시 헬스 무료 여부	0
나 뭐 물어볼 게 있는데 너 미국 갔을 때 계좌 새로 만들었었어	미국 계좌 새로 만들었는지	0
어젯밤 보낸 이메일 중 송신이 확인된 이메일 몇 통인가	어젯밤 보낸 이메일 중 송신이 확인된 이메일 수	2
갈 수 있지	갈 수 있는지	0
올해 졸업했지 취직준비는 잘 돼가니 	취직준비 잘 돼가는지	0
다음 주 목요일에 만나기로 한 사람이 누구야	다음주 목요일 만나는 사람	2
어제 배 아프다고 조퇴까지 하더니 괜찮니 	배 괜찮은지	0
현재 황사 주의보가 내려진 지역 어딘가	현재 황사 주의보 내려진 지역	2
내릴 때 카드 안 찍으면 환승 안 돼	내릴 때 카드 안 찍으면 환승 안되는지	0
그러면 금융권의 간접투자 상품이 어떠신지요 	금융권 간접투자 상품 어떤지	0
못 믿겠어	못 믿겠는지	0
어떠세요	어떤지	2
이번 연휴에는 하루만 추가해서 쉬어	이번 연휴 하루만 추가해서  쉬는지	0
성남 일화의 최근 기사를 보여	성남 일화 최근 기사	2
바나나보트인가 사과보트인가 그것도 한번도 안타봤어	바나나보트 사과보트 한번도 안타봤는지	0
카드 할부 수수료 얼마나 나와	카드 할부 수수료	2
우체국과 은행 중 어디가 더 안전할까 	우체국 은행 중 안전한 것	1
체크 아웃은 몇 시에 해	체크 아웃 시간	2
과음하시더니 속은 좀 어떠세요 	속 괜찮은지	0
어제 회식 자리에 왜 안 오셨어요	어제 회식 안 온 이유	2
현금 지급기로도 계좌이체 할 수 있어	현금 지급기 계좌이체 가능 여부	0
압구정동 스파게티 전문점은	압구정동 스파게티 전문점	2
네 카드 되지	카드 되는지	0
내것도 함께 취소해	내것 함께 취소할지	0
서울 여가 일식집은 어디에 있어	서울 여가 일식집 위치	2
디지털 카메라는 니콘이 좋은 거 같아	디지털 카메라 니콘이 좋은지	0
달달 외워야하는 스타일로 문제 출제하셔	외워야하는 스타일 문제 출제하시는지	0
전자회로 숙제 몇 번 몇 번이야	전자회로 숙제 번호	2
우리 그럼 몇 년 뒤에 만나는 거야	몇 년 후에 만나는지	2
이번에 시험 주제는 자유래	이번 시험 주제 자유인지	0
주식이 오른다는 예상은 어떤 과정을 통해 나온 건가요	주식 오른다는 예상 나온 경위	2
첨부 파일이 든 이메일 몇 통이나 된데	첨부파일 든 이메일 수	2
대리님 치과는 다녀오셨어요	치과 다녀왔는지	0
비즈니스 영어 수업은 시간이 어떻게 된대 	비즈니스 영어 수업 시간	2
통장에 십만원 들어와 있던데 누가 보낸 건지 알아	통장 십만원 보낸 사람	2
오늘 컨디션은 괜찮아 	오늘 컨디션 괜찮은지	0
성북구 길음동 근처 햄버거 어디냐	성북구 길음동 근처 햄버거 위치	2
토요일 수업 있니	토요일 수업 여부	0
오늘 전국 한낮의 체감온도는 얼마나 된데	오늘 전국 한낮의 체감온도	2
당신은 왜 약속을 지키지 않나요 	약속 지키지 않는 이유	2
거래처 대표와 만나기로 한 날은 언제야	거래처 대표 만나기로 한 날	2
그 광고 언제쯤 인쇄가 끝난다는 거야	광고 인쇄 끝나는 시기	2
직행 버스로 예약해	직행 버스 예약할지	0
너 대학국어 뭐 받았냐	대학국어 성적	2
이번 태풍 때문에 산사태 심하게 났다며 너네 집은 괜찮아	집 괜찮은지	0
언제 교육방송에서 수학방송 하지	교육방송 수학방송 시간	2
그 은행에 대해서 자세히 알고 있어	그 은행 정보	2
그 곳은 왜 버스로는 갈 수 없는 걸까 	버스 갈 수 없는 이유	2
하루에 공부양은 얼마 안돼요	하루에 공부양 얼마 안되는지	0
중앙 내륙 고속도로 완공 됐어	중앙 내륙 고속도로 완공 됐는지	0
요즘 수익률 높은 종목이 뭐야	요즘 수익률 높은 종목	2
지금 인터넷 회원 가입하면 손거울 준대	지금 인터넷 회원 가입하면 손거울 주는지	0
이번 주 우리 회사 이벤트 파티에 와	이번 주 우리 회사 이벤트 파티 오는지	0
얼마 동안 투숙할 일정이냐	투숙 일정	2
요즘 뭐하고 지내 학교는 잘 다니고 있지	학교 잘 다니는지	0
버스가 좋을까 지하철을 타고 가는 것이 빠를까 의견주세요	버스 지하철 중 타고 갈 것	1
지금 강남대로 막히는지 알 수 있을까	지금 강남대로 막히는지	0
오늘 충전상태는 어떻지	오늘 충전상태	2
돈 없어	돈 없는지	0
사 번 트랙이요	사 번 트랙인지	0
네 직업 위험도는 몇 등급인 줄 알고 있어 	직업 위험도 등급	2
공짜 점심 먹고 싶은 사람	공짜 점심 먹을 사람 있는지	0
부산대학병원에서 제일 가까운 약국은 어디야	부산대학병원 제일 가까운 약국	2
해외에서 국내 신용카드를 써도 되니 	해외 국내 신용카드 사용 가능 여부	0
부산 진구 종합병원의 위치는	부산 진구 종합병원 위치	2
오늘 왜 아는 척도 안했어 	오늘 아는 척 안한 이유	2
관리비 내는 날이 언제지	관리비 내는 날	2
댁의 아들은 학교에 잘 다니나요 	아들이 학교에 잘 다니는지	0
인터넷쇼핑몰은 계좌번호를 어떻게 알아 	인터넷쇼핑몰 계좌번호 아는 이유	2
오늘이 무슨 요일이야	오늘 요일	2
만약 우리 사귀자면 우리 사귈 수 있을까	사귈 수 있을지	0
맨 앞에서 탈까 맨 뒤에서 탈까 	맨 앞 맨 뒤 중 탈 곳	1
휴대폰으로 주식 매매하면 수수료가 얼마쯤 나오니	휴대폰 주식 매매 수수료	2
백두산 한 달 여행비용은	백두산 한 달 여행비용	2
우리 오빠가 너 잘 지내고 있냐고 물어보라더라	잘 지내는지	0
통장 만들려면 뭐가 필요하지 	통장 만드는 데 필요한 것	2
비가 올까 맑을까	비가 올지 맑을지	1
이번 해외 파견 근무에 신청했어	해외 파견 근무 신청 여부	0
뮤추얼 펀드가 뭔지 혹시 아니	뮤추얼 펀드 의미	2
내일 사정이 생겨서 약속 취소해야 할 것 같은데 괜찮아 	약속 취소 괜찮은지	0
보드 타러 가실래요	보드 탈지	0
그 설계도 초안 작성은 마쳤어	그 설계도 초안 작성은 마쳤는지	0
독일 문화원에서 독일어 수업 들을 수 있을까 	독일 문화원 독일어 수업 가능 여부	0
사일날 일정이 어떻게 되니	사일날 일정	2
요즘은 음란 사이트도 사내에 다 차단 돼있어	음란 사이트 사내 차단 여부	0
영동 고속도로에서 동서울 진입 구간의 현황이 어때	영동 고속도로 동서울 진입 구간 현황	2
경부 고속도로 내 소통이 원활한 구간 얼마나 되지	경부 고속도로 내 소통 원활 구간 정도	2
선생님 요즘 저기압이셔	선생님 요즘 저기압인지	0
오늘 새 편지 중 정미 아이디로 된 메일이 있는가	오늘 새 편지 중 정미 아이디로 된 메일 있는지	0
수영이랑 헬스 중에 뭐가 더 좋아	수영 헬스 중 좋은 것	1
제주도에서 목포로 가는 배편이 어떻게 되요	제주도 목포 배편	2
올 오 월에 미라 언니 결혼한대요	올 오 월 미라 언니 결혼 여부	0
오늘 내가 누구에게 메일을 보냈니	오늘 내가 메일 보낸 사람	2
펜션으로 갈까 아니면 호텔 돈도 없는데 그냥 민박할까	펜션 갈지 민박할지	1
나 새 차 살건 데 뭐가 좋을까	새 차 살만한 것	2
마이애미로 가시나요	마이애미 가는지	0
이번 주의 전국날씨 어떠냐	이번 주 전국날씨	2
학교 약국 지금 열었을까	학교 약국 지금 열었을지	0
마지막 파트가 제일 어려워	마지막 파트 제일 어려운지	0
회신 메일은 모두 몇 통이야	회신 메일 수	2
경부 고속도로의 노면상황이 좋으니	경부 고속도로 노면상황 좋은지	0
옛날 생각난다 너 어릴 때는 귀여웠는데 지금은 어떠니 	지금도 귀여운지	0
이번에 우리 아기 보험을 하나 들려고 하는데 뭐가 좋아	좋은 아기 보험	2
서울역 근처 볼링장 어딘데	서울역 근처 볼링장	2
상장예정이 벌써 지났어	상장예정 지났는지	0
꼭 그 은행만 되는 거야 	그 외 은행 가능 여부	0
야유회 비용은 회사 부담 이야	야유회 비용 회사 부담인지	0
호우 특보가 내려진 지역은 어디지	호우 특보 지역	2
약물 남용은 몸에 큰 영향을 미치니	약물 남용 몸 영향 여부	0
압구정동에서 뼈를 가장 잘 붙이는 정형외과 어딘데	압구정동 뼈 가장 잘 붙이는 정형외과	2
해외 수주 소식이 연이어 들리니 건설주를 사보는 건 어때 	건설주 사는건 어떤지	0
부동산과 주식 중에 어느 곳에 투자하면 좋을까	부동산 주식 중 투자하면 좋을 곳	1
선물 옵션이 뭐를 말하는 건지 잘 모르겠어	선물 옵션 의미	2
무슨 말인데	말 의미	2
지난주에 오기로 한 물량이 왜 아직도 안 도착한 거죠	지난주 오기로 한 물량 아직 안 도착한 이유	2
오늘이 무슨 요일이지	오늘 요일	2
너 공부 잘 돼	공부 잘 되는지	0
너희 은행도 방카슈랑스 하니	은행 방카슈랑스 여부	0
동창회 하는 날은 언제인데	동창회 날짜	2
오늘 날씨는 어때	오늘 날씨	2
더 좋은 회사에서 스카우트 제의 받았어	더 좋은 회사에서 스카우트 제의 받았는지	0
막 차는 몇 시에 있어요	막차 시간	2
수업을 시작한 날이 언제지	수업 시작일	2
공무원은 정확히 어떤 업무를 해 	공무원 업무	2
강남역 근처 일마레 어디냐	강남역 근처 일마레 위치	2
교수님 연구실이 몇 호실이지 	교수님 연구실 위치	2
정말 갈까	정말 갈지	0
지금 몇 시지	지금 시간	2
금융자산관리사 자격증 좀 딸려고 하는데 신뢰도가 제일금융권이 좋을까 아니면 제이 금융권이 좋을까	신뢰도 제일금융권 제이금융권 중 좋은 것	1
샐러드나 소스는 어떠세요	샐러드나 소스 어떤지	2
아직도 이십 칠 번 국도 정체가 심한가	아직도 이십 칠 번 국도 정체가 심한지	0
비행기를 예약하려고 하는데 인터넷 예매가 가능한가요 	비행기 예약 인터넷 예매 가능 여부	0
오늘 새 편지 중에 정미 아이디로 된 메일이 있데	오늘 새 편지 중 정미 아이디로 된 메일 여부	0
주식이 정확하게 무엇을 뜻하는 건지 알아 	주식 의미	2
그 은행 영업시간은 네 시 까지야	그 은행 영업시간 네 시 까지인지	0
모의투자가 실제투자와 다른 점은 뭐니 	모의투자 실제투자 차이점	2
왜 그리 잘 아는데도 취미로만 주식을 하는 거야 	취미로만 주식 하는 이유	2
늦을 거야	늦는지	0
미리는 중국으로 유학 갔대	미리 중국 유학 갔는지	0
내일 오존 경보지수가 얼마나 되지	내일 오존 경보지수	2
현금 카드 하나 만드려고	현금 카드 하나 만드는지	0
시드니까지 할인 항공권 있나요	시드니까지 할인 항공권	2
혹시 십육 일 날 학교 가시나요	십육 일 날 학교 가는지	0
제목에 회신이 들어간 메일이 있니	제목 회신 들어간 메일 여부	0
온도가 몇 도야	온도	2
과천시 소재 서울랜드는	과천시 소재 서울랜드	2
내일 저녁 어떠세요	내일 저녁 어떤지	0
첨부파일이 들어 있는 이메일은 몇 개지	첨부파일 들어 있는 이메일 수	2
대출이율이 가장 싼 상품은 뭐고 이율은 얼마에요	대출이율 가장 싼 상품과 이율	2
라식 수술 후에 후유증 없데	라식 수술 후 후유증 여부	0
혜진이한테 얘기 들었어	혜진이한테 얘기 들었는지	0
미아삼거리에서 왼쪽 길로 꺾어지는 거 맞지	미아삼거리에서 왼쪽 길로 꺾어지는 거 맞는지	0
골프가 너의 건강 유지 비결이니	골프 건강 유지 비결 여부	0
지방 축제 행사 촬영이 있어서 가는데 데려 가 줄까 	지방 데려가 줄지	0
부산까지 요금은 얼마니	부산까지 요금	2
침대로 던져줄까 그냥 내려줄까 	침대로 던져줄지 그냥 내려줄지	1
주식은 노력해서 잘 할 수 있는 걸까요	주식 노력해서 잘 할 수 있는지	0
청담동에서 가장 유명한 네일숍 어떻게 가지	청담동 가장 유명한 네일숍 가는 방법	2
주요 도시의 강수 분포도는 얼마일까	주요 도시 강수 분포도	2
태권도 한 번 배워 보고싶어	태권도 배워 보고싶은지	0
약속 취소됐어	약속 취소됐는지	0
적금으로 월급의 반이 나가	적금으로 월급 반이 나가는지	0
대출 하려고 하는데 유가증권 담보도 가능한가요	유가증권 담보 가능 여부	0
출장 계획이 전면 바뀌었어요	출장 계획 전면 바뀌었는지	0
현재 태풍의 진행 상황은 어떻지	현재 태풍 진행 상황	2
어젯밤 이메일 중 첨부 파일이 든 이메일은 몇 통인가	어젯밤 이메일 중 첨부 파일 든 이메일 수	2
은행원들은 대출 받기 쉬울까 	은행원 대출 쉬울지	0
지역별로 구름의 양이 얼마나 되지	지역별 구름 양	2
코스닥과 나스닥의 차이가 뭐니	코스닥 나스닥 차이	2
비행기편 변경 가능한가요	비행기편 변경 가능 여부	0
캐리비안베이 입장권이 얼마지	캐리비안베이 입장권 가격	2
거래처와 어디서 만나기로 했나 	거래처 만나는 장소	2
용가리파와 결투시간 언제지	용가리파 결투시간	2
남편 서울 출장가는 날이 언제지	남편 서울 출장일	2
증권 할 때 주로 어떤 지표나 정보를 눈여겨봐야 하는지 아니	증권 눈여겨볼 지표 정보	2
내가 아침 운동을 하는 날짜가 언제인가	내가 아침 운동 하는 날짜	2
컴퓨터로 할 수 있는 사업들에 대해 알고 싶어	컴퓨터로 할 수 있는 사업들	2
평균 점수 못 넘으면 맞는데	평균 점수 못 넘으면 맞는지	0
효과적인 영어 학습법은 무엇이 있을까요 	효과적 영어 학습법	2
그렇게 해도 돼	그렇게 해도 되는지	0
회사주식이 코스닥에 등록 돼있니 	회사주식 코스닥 등록 여부	0
몸 안 좋다더니 병원에 다녀왔어	병원 다녀왔는지	0
운임은 얼마냐	운임	2
언니 보고 싶어서 눈이 짓물렀어요 우리 언제 보는 거죠 	언제 볼지	0
열차표 예약해	열차표 예약하는지	0
그는 어떤 사람인가요	그의 정체	2
어제 과음하더니 출근은 했어	출근했는지	0
나쁘진 않아	나쁘진 않은지	0
지근 번영로 막히나	지근 번영로 막히는지	0
오늘 부산에도 눈이 내리니	오늘 부산 눈 여부	0
전에 이야기했던 식사대접을 오늘 해도 되려 나요	식사대접 오늘 가능 여부	0
서울에서 제일 저렴한 예식장 어떻게 가	서울 제일 저렴한 예식장 가는 방법	2
내가 주식을 매각 할수 없는 이유가 뭐냐	내가 주식 매각할 수 없는 이유	2
부산진역 앞 루반도르는 어떻게 가는가	부산진역 앞 루반도르 가는 방법	2
신림동 근처 문구점은 어떻게 간데	신림동 근처 문구점 가는 방법	2
스탭퍼하면 종아리가 굵어지지 않을까	스탭퍼 종아리 굵어지는지	0
적금 타는 날은 언제인데	적금 타는 날 	2
돈 있어	돈 있는지	0
버스 어디서 갈아 타면 돼	버스 갈아탈 곳	2
인공누액 안주기로 했다는거 알고있었니	인공누액 안주는거 알고 있었는지	0
부산 서울 간 막차가 언제 있지	부산 서울 간 막차 시각	2
복싱이 다이어트에 효과가 있어	복싱 다이어트 효과 여부	0
복날은 며칠이지	복날 날짜	2
오늘 수업시간에 컴퓨터 준비 해야 돼나 	오늘 수업시간 컴퓨터 준비해야 되는지	0
외국인 투자자들의 동향은 좀 어떠니 	외국인 투자자 동향	2
제 자리는 어디에요	제 자리 위치	2
집에 지금 갈 건가요	집 지금 갈지	0
선생님 오늘 과외 못 할 것 같아요	오늘 과외 하는지	0
장외 주식 매입 하고 싶어	장외 주식 매입 하고 싶은지	0
마지막 요점 정리는 어떻게 하는데 	마지막 요점 정리 방법	2
내일 바람 많이 부니	내일 바람 많이 부는지	0
오늘 오전에 도착한 메일은 몇 통인가	오늘 오전 도착 메일 수	2
이번 주 숙제를 며칠까지 해야지	이번 주 숙제 기한	2
홍은동 녹번역 구간의 교통상황 어떤가	홍은동 녹번역 구간의 교통상황	2
많이 맞으면 맷집이 과연 좋아질까 	많이 맞으면 맷집 좋아질지	0
화이트데이가 무슨요일이지	화이트데이 요일	2
그게 있어야 마무리가 될 것 같아	그게 있어야 마무리되는지	0
갈아타는 곳은 어디에요	갈아타는 곳	2
경기도 인근 에버랜드는 어디냐	경기도 인근 에버랜드 위치	2
남쪽 베란다 창문 보여	남쪽 베란다 창문 보이는지	0
정말 아프니	정말 아픈지	0
뉴욕 증시의 상승기조가 이어질 지 궁금하네	뉴욕 증시 상승기조 이어질지	0
필리핀과 태국중에 어디 상품이 더 싸니	필리핀 태국 중 상품이 더 싼 곳	1
증권거래소랑 코스닥 중 어느 곳이 좋아	증권거래소 코스닥 중 좋은 곳	1
신촌의 유명한 갈비전문점은 어디야	신촌 유명 갈비전문점	2
내일 클럽활동 뭐하니	내일 클럽활동	2
이번에 장학금 수혜자 발표 나왔어	이번 장학금 수혜자 발표 나왔는지	0
너 수학 교육학과에 친구 없니	수학 교육학과 친구 여부	0
우리 금요일 날 여기서 보는 거야	금요일 날 여기서 볼지	0
내일 진우오빠 휴가 나온대요	내일 진우오빠 휴가 나오는지	0
동의대 주변 플레이스테이션 방은 어떻게 가	동의대 주변 플레이스테이션 방 가는 방법	2
실시간으로 내 주식의 등락폭을 알 수 있는 방법은 뭘까요	실시간 주식 등락폭 알 수 있는 방법	2
동생으로부터 첫 편지가 왔어	동생으로부터 첫 편지 왔는지	0
엄마 괜찮아 내가 지금 약 사가지고 들어갈게 	괜찮은지	0
이상해	이상한지	0
의정부 소재 부대찌게 전문점 어떻게 가니	의정부 소재 부대찌게 전문점 가는 방법	2
그 과제는 야외에서 촬영하는 거야	그 과제 야외 촬영하는지	0
영화 예약했지	영화 예약했는지	0
오늘 무슨 날이야 검문 경찰이 쫙 깔렸어	오늘 특별한 날인지	0
롯데백화점 근처 전통 독일식 맥주집은 어디니	롯데백화점 근처 전통 독일식 맥주집	2
결혼을 앞두고 있는데 어떤 금융상품이 괜찮을까요	결혼 앞두고 괜찮은 금융상품	2
경부 고속도로 정체구간은 어떨지	경부 고속도로 정체구간 상황	2
낙성대에서 내려서 오는 게 빨라	낙성대에서 내려서 오는 게 빠른지	0
헬스를 할까 아님 수영을 할까	헬스 수영 중 할 것	1
요번 시험에 승규가 일등 했어	요번 시험 승규 일등 했는지	0
시험 계획표 책상에 붙여 뒀어	시험 계획표 책상에 붙여 뒀는지	0
다음달은 며칠이 쉬는 날이니	다음달 쉬는 날	2
오늘 종합주가지수 몇 포인트야	오늘 종합주가지수	2
알았어요 얼마나 되죠	얼마나 되는지	0
우리 삼 년 후에 파 보기로 했던 타임캡슐 아직 잘 있겠지 	타임캡슐 잘 있는지	0
나 이번에 엉망이야 넌 몇 등 했냐	등수	2
좀 싼 호텔 있나요	좀 싼 호텔 있는지	0
잠원역에서 만나서 같이 갈까 아니면 안에서 볼까	잠원역에서 만나서 같이 갈지 안에서 볼지	1
고향 뭐 타고 내려갈 거야	고향 타고 내려갈 것	2
칠월 사일이 회사 창립 기념일이야	칠월 사일 회사 창립 기념일인지	0
어린이 운임 얼마지	어린이 운임	2
선배가 너 괴롭힌다더니 아직도 그래 	선배 아직 괴롭히는지	0
이렇게 어색할 수가 어떻게 해야 친해지는 거야	친해지는 방법	2
기억하고 있어	기억 여부	0
그 외에 금융회사를 예를 든다면 어떤 것이 있을까요 	금융회사 예	2
내일 아침에 영하래	내일 아침 영하인지	0
건강하지	건강한지	0
전남대 근처 축협은 어디지	전남대 근처 축협 위치	2
이 근처에서 좋은 레스토랑을 추천해주실래요	이 근처 좋은 레스토랑	2
제대하는 날까지 얼마나 남았지	제대까지 남은 기간	2
개인 계좌조회를 할수 있나요 	개인 계좌조회 가능 여부	0
끝내기만 하고 그냥 왔어	끝내기만 하고 그냥 왔는지	0
입금표 계좌번호를 입력하면 자동으로 이름이 떠	입금표 계좌번호 입력하면 자동으로 이름이 뜨는지	0
오늘 스팸 메일은 몇 통이지	오늘 스팸 메일 수	2
엄마 가방에 있던 돈 돌려줘야 할까 아님 그냥 넘어갈까 	엄마 가방 돈 돌려줄지 그냥 넘어갈지	1
지금 회의해	지금 회의 여부	0
어제 시험 끝내고 좀 여유가 생겼나	여유 생겼는지	0
김 대리님 하고 차장님 하고 싸우셨어	김 대리님 차장님 싸웠는지	0
더운데도 이불 뒤집어 쓰고 있어	이불 뒤집어 쓰고 있는지	0
사업계획서 작성시 의뢰를 하는 편인가요 	사업계획서 작성 의뢰 하는 편인지	0
자기앞수표 만들 때 수수료 들어가지 	자기앞수표 수수료 여부	0
오늘 아침에도 수영장 다녀오셨어요	오늘 아침 수영장 다녀왔는지	0
지금 강남대로 교통흐름이 어떻지	지금 강남대로 교통흐름	2
기대 이상이야	기대 이상인지	0
오늘 사회면 주요 소식은 뭔가	오늘 사회면 주요 소식	2
지금 시간이 어떻게 돼니	지금 시간	2
여기는 날씨가 많이 추워 거기는	날씨 추운지	0
톨게이트 비용도 외상이 가능할까 	톨게이트 비용 외상 가능 여부	0
오늘 연구실에 사람들 나와 있나요	오늘 연구실 사람들 있는지	0
현재 중부 고속도로 노면 상태는	현재 중부 고속도로 노면 상태	2
조금 나왔지	조금 나왔는지	0
부산대 주변 나이트클럽은 어디니	부산대 주변 나이트클럽 위치	2
개인 주식 투자가들은 잃는 경우가 많아	개인 주식 투자가 잃는 경우 많은지	0
국제유가 상승과 원자재 가격 상승이 어떤 의미야	국제유가 상승 원자재 가격 상승 의미	2
그 사람을 왜 채용했는지 묻고 싶다	그 사람 채용 이유	2
내일 트렌치코트 입으면 상당히 추울까	내일 트렌치코트 입으면 추울지	0
경포대 근처에서 제일 좋은 노래방은	경포대 근처 제일 좋은 노래방	2
지금 우리는 어디에 있어요	지금 우리가 있는 곳	2
치마 입을까 바지 입을까	치마 바지 중 입을 것	1
이번 계절학기 수업 갯수가 몇 개나 되지	이번 계절학기 수업 개수	2
이번 합창대회 때 우리반이 우승할 수 있을까	이번 합창대회 우승 가능 여부	0
그 교수님 수업 괜찮니	교수님 수업 괜찮은지	0
통도사에서 양산 방향 사고 처리 끝났나	통도사 양산 방향 사고 처리 끝났는지	0
인천 공항에 황사 주의보 내려졌니	인천 공항 황사 주의보 여부	0
서울의 전운량이 얼마나 되지	서울 전운량	2
바이어 측에서 좋은 대답 왔어	바이어 측에서 좋은 대답 왔는지	0
태석이 장난감 언제 도착하니	태석이 장난감 도착 시기	2
너 교양수업 몇 학점이나 들어 	교양수업 학점 수	2
이번 버스 요금 인상은 며칠부터인데	이번 버스 요금 인상 날짜	2
카드 결제는 무조건 본인이 해야 맞는 거야	카드 결제는 무조건 본인이 해야 맞는지	0
신촌역 앞 편의점은 어디일까	신촌역 앞 편의점 위치	2
타 은행으로 인터넷 뱅킹할 때 수수료 얼마 붙는지 알아 	타 은행으로 인터넷 뱅킹 수수료	2
비도 오는데 주말은 뭐하고 보냈어 	주말 한 것	2
지금 그게 외국인 매도 일 위야	지금 그게 외국인 매도 일 위인지	0
오늘 대구의 풍속은 얼마지	오늘 대구 풍속	2
이번에 고향에 내려갈 때는 비행기 타고 갈 거야 	이번 고향 내려갈 때 비행기 타고 갈지	0
주가 매도 상태 유지하고 있어	주가 매도 상태 유지 여부	0
초복이 언제지	초복 날짜	2
그 아르바이트 하기로 약속 한 거야 	그 아르바이트 하는지	0
잠실에서 종로 가는 길 안 밀리나	잠실에서 종로 가는 길 상황	2
큰 아들이 언제 미국으로 들어가지	큰 아들 미국 들어가는 시기	2
지금 코스닥 시세가 어떻게 되지 	지금 코스닥 시세	2
펜팔 하면 확실히 외국어 실력이 많이 늘어	펜팔 외국어 실력 느는지	0
칠과 팔중 어떤걸 더 좋아하지 	칠과 팔중 좋은 것	1
어제 헤드라인 기사가 뭐였는데	어제 헤드라인 기사	2
우리 사촌오빠가 수학 잘 가르치는데 배워볼래	사촌오빠에게 수학 배워볼지	0
남포동 주변 매운탕 집 어떻게 가냐	남포동 주변 매운탕 집 가는 방법	2
이건 어디 제품이죠	제품 회사	2
구월 삼십일일이 마감날이야	구월 삼십일일 마감날인지	0
오늘의 주요 기사는 뭐니	오늘 주요 기사	2
여태까지 사고 난 적 한 번도 없었어	사고 난 적 한 번도 없었는지	0
서울대학교 근처에 우동집은 어떻게 가니	서울대학교 근처 우동집 가는 방법	2
여유 자금 굴릴 곳 좀 없을까요	여유 자금 굴릴 곳	2
우리동네 분리 수거 수거일이 언제야	우리동네 분리 수거 수거일	2
닭 직접 튀긴 거 먹고 싶지 않아 	닭 직접 튀긴 거 먹고 싶지 않은지	0
환전은 외환은행 말고 아무 은행에서라도 할 수 있는 거지	환전 가능 은행	2
지금 강남대로 막히는지 알 수 있을까	지금 강남대로 막히는지	0
차두리의 중징계 관련 기사는	차두리 중징계 관련 기사	2
거품이 빠지면서 갑자기 폭락하면 어쩌지	폭락 대책	2
내일 조회 필드발표 준비했냐	내일 조회 필드발표 준비 여부	0
미술학원 몇 시에 가야돼니	미술학원 갈 시간	2
너 수업 시작했는데 왜 아직 안 오냐 	안 오는 이유	2
아직 카드 하나 쓸 정도는 돼	카드 하나 쓸 정도는 되는지	0
요즘 스포츠 댄스가 유행이야	요즘 스포츠 댄스 유행인지	0
나 점심 사줬으니까 음료수 사줄게 뭐 마실래 	마실 음료수	2
기말고사 시험범위 알어	기말고사 시험범위	2
대전에서 서울가는 국도가 막히는 곳 있니	대전에서 서울가는 국도 막히는 곳	2
나와 있어	나와 있는지	0
나쁜 소식과 기쁜 소식 중 무엇부터 들을래	나쁜 소식 기쁜 소식 중 먼저 들을 것	1
부산시 진입로의 정체구간 어디지	부산시 진입로 정체구간	2
지난 학기 과톱이 누구였더라  	지난 학기 과톱	2
차 가지고 갈 거야 피곤한데 그냥 버스 타고 갈까	차 가지고 갈지 말지	0
정말로	정말인지	0
그 뮤지컬은 다들 별로래	그 뮤지컬 다들 별로라는지	0
남산터널이 붐비는지 알고싶어	남산터널 붐비는지	0
이번 수능 어려웠다던데 재수할 거야 	재수 여부	0
오늘 북한 소식 뭘까	오늘 북한 소식	2
주식 계좌 이체도 예금의 현금이체와 동일해	주식 계좌 이체와 예금 현금이체 동일한지	0
종로에서 제일 큰 약국은 어디야	종로 제일 큰 약국	2
달맞이 고개에서 전망 제일 좋은 음식점은 어떻게 가냐	달맞이 고개 전망 제일 좋은 음식점 가는 방법	2
네가 예전에 다녔던 학원은 어때 	예전에 다녔던 학원 어떤지	2
제주도 갈 때 배타고 갈까 아님 비행기 타고 갈까	제주도 갈때 배 비행기 중 타고 갈 것	1
이게 웬 미납고지서냐 가스요금 안 냈어 	가스요금 냈는지	0
요즘 추운데 잘 지내냐	잘 지내는지	0
대한항공 운임 얼마야	대한항공 운임	2
내가 얼마의 주식을 보유해야 그 회사 경영에 참여할 수 있지	회사 경영 참여하려면 보유해야 할 주식	2
현금카드 재발급 수수료 비싸냐	현금카드 재발급 수수료 비싼지	0
오늘 저녁 밥은 누구랑 먹니	오늘 저녁 밥 같이 먹는 사람	2
지금 클라이언트를 구하고 있대	지금 클라이언트 구하는지	0
교통사고라도 의료보험 처리가 가능한지 	교통사고 의료보험 처리 가능 여부	0
분당 율동공원 가기로 한 날짜가 언제니	분당 율동공원 가기로 한 날짜	2
지역별로 전운량은 얼마야	지역별 전운량	2
광안리에 선지국밥 전문점은	광안리 선지국밥 전문점	2
열기구가 추운 날씨에 잘 뜨는 이유가 뭐죠 	열기구 추운 날씨 잘 뜨는 이유	2
동창회에서 온 공지메일이 있어	동창회 공지메일 있는지	0
자전거 타기에는 여의도가 좋아	자전거 타기에 여의도 좋은지	0
과천에 있는 한식당 어떻게 가	과천 한식당 가는 방법	2
내일이 발표 날인데 준비는 다 되 있죠	발표 준비 여부	0
정형외과와 한의원 중 어디가 좋을까요	정형외과 한의원 중 좋은 것	1
이번 주에 제사가 있냐	이번 주 제사 여부	0
급행 요금은 얼마에요	급행 요금	2
부산 가려면 고속도로보다 기차 타는 게 더 빨라	부산 가려면 고속도로보다 기차 타는 게 더 빠른지	0
요금 얼마니	요금	2
경부 고속도로에 노면이 결빙된 구간은	경부 고속도로 노면 결빙 구간	2
부모님도 모두 안녕하시니	부모님 모두 안녕하신지	0
오늘 주식시장의 주요 소식은	오늘 주식시장 주요 소식	2
거의 예체능은 실기시험이 있어	거의 예체능은 실기시험이 있는지	0
나 없는 동안 너무 외로웠지 	나 없는 동안 외로웠는지	0
다음 동기모임 여의도에서 하기로 결정났어	다음 동기모임 여의도에서 하는지	0
세미나 끝나고 그린호프에서 뒷풀이 한대	세미나 끝나고 그린호프에서 뒷풀이 하는지	0
별일은 없고	별일 없는지	0
구월달 부산 지방의 전반적인 기상 전만은 어떤가	구월달 부산 지방 전반적인 기상 전만	2
오늘 외국인 순매수 규모가 커	오늘 외국인 순매수 규모가 큰지	0
요즘 건강은 어때	요즘 건강	2
주식으로 번 돈은 쉽게 쓴다는데 도대체 왜 그런거야	주식으로 번 돈 쉽게 쓰는 이유	2
이회택 최순호 코치의 근황에 대한 기사는 없을까	이회택 최순호 코치 근황 기사	2
요금 얼마니	요금	2
교원평가를 꼭 해야만 하나요 	교원평가 필요 여부	0
나 척추 휜 거 같은데 어떻게 하지	척추 휠 때 대책	2
넌 주말인데 집에서 뭐하냐 	주말 집에서 하는 일	2
얼마나 필요하세요	필요한 양	2
좀 더 안전하고 수익률 높은 외국환에 대한 투자는 어떠세요 	외국환 투자 어떤지	0
건강 보험 비교 사이트 있나요 	건강 보험 비교 사이트	2
일본 날씨가 어떻지	일본 날씨	2
고속도로랑 국도 중에 어디가 나을까	고속도로 국도 중 나은 곳	1
고금리 특판 예금 괜찮을까 	고금리 특판 예금 괜찮을지	0
어제 보낸 메일 중 수신 확인 안 된 메일 몇 통인가	어제 보낸 메일 중 수신 확인 안 된 메일 수	2
저한테 맞는 것 있나요	저한테 맞는 것 있는지	0
까쓰오븐 끄고 잠글까	까쓰오븐 끄고 잠글지	0
우리 교양수업 야외에서 한다는 거 어디서 하는 거야 	야외 교양수업 위치	2
안녕	안녕한지	0
내 휴대폰이 지금 어떠한 상태지	내 휴대폰 상태	2
집에 나 말고 누가 있지	집에 있는 사람	2
내일 특별한 일정 있어	내일 특별한 일정 있는지	0
며칠 전에 학교에서 졸업식이 있었대	며칠 전 학교에서 졸업식이 있었는지	0
시험까지 몇 분 남았지	시험까지 남은 시간	2
컴퓨터 새로 다 바꾼데	컴퓨터 새로 다 바꾸는지	0
같이 없어	같이 없는지	0
딸아이 생일선물 사기로 한 날이 언제야	딸아이 생일선물 사기로 한 날	2
회사에 복장 규정이 있나요	회사 복장 규정 여부	0
형 모니터는 십구 인치로 살까 이십 인치로 살까	모니터 십구 인치 이십 인치 중 살 것	1
책상위에 전화번호부 있어	책상위 전화번호부 있는지	0
비행기에 몇 시에 예약했데	비행기 예약 시간	2
오늘 저녁에 쇼핑 갈까 술 한 잔 할까 	오늘저녁 쇼핑갈지 술한잔 할지	1
이 번호로도 있나요	이 번호로도 있는지	0
오늘 저녁 일곱시 약속은 어디야	오늘 저녁 일곱시 약속 위치	2
재산세 내는 날까지 얼마나 남았지	재산세 내는 날까지 남은 기간	2
점심은	점심 먹었는지	0
축구와 농구 중에 어떤 운동을 좋아해	축구 농구 중 좋아하는 것	1
운전 면허 금방 딸 수 있어	운전 면허 금방 딸 수 있는지	0
칠월 이일이 일요일이야	칠월 이일 일요일인지	0
제주도 관광콕스에 대해 알고싶어	제주도 관광콕스	2
보고싶다 친구야 잘 지내지 	잘 지내는지	0
엔화와 유로 중 어떤 것을 사는 것이 이득일까 	엔화 유로 중 살 것	1
겨울방학 토플강좌 일정이 어떻게 돼	겨울방학 토플강좌 일정	2
사모님과 여행 잘 다녀 오셨나요	여행 잘 다녀왔는지	0
까쓰오븐 이백 오십 도로 예열하니	까스오븐 이백 오십 도 예열 여부	0
서초동 인근 빨래방은 어떻게 가지	서초동 인근 빨래방 가는 방법	2
티브이 보는 것도 취미 활동이라고 할 수 있을까 	티브이 보는 것 취미 활동 여부	2
골프공처럼 튈 수 있는 주식을 사라는데 그게 뭐야 	골프공처럼 튈 수 있는 주식 의미	2
의료보험 카드없어도 돼	의료보험 카드없어도 되는지	0
요새 유언비어가 너무 많은데 그 정보 확실한 거야 	그 정보 확실한지	0
내일 오륙도의 파고는 얼마나 높지	내일 오륙도 파고	2
교수님 연구실이 몇 호실이야	교수님 연구실 호실	2
호호야 너 어딨어	지금 위치	2
공부가 제일 쉬웠다는 말은 거짓말이야	공부가 제일 쉬웠다는 말 거짓말인지	0
목동교는 현재 서행구간인가	목동교 현재 서행구간 여부	0
주식을 하려면 주식계좌를 새로 만들어야 돼	주식 하려면 주식계좌 새로 만들어야 되는지	0
건강을 유지할려면 어떤 방법이 좋을까요	건강 유지 방법	2
요즘 재수 씨는 잘 지내시지	재수 씨 잘 지내는지	0
스톡옵션 보유하고 있어	스톡옵션 보유 여부	0
고깃집에서 만나는 거냐 횟집에서 만나는 거냐 	고깃집 횟집 중 만나는 곳	1
카드로 샀어	카드로 샀는지	0
지하철이나 버스 이용 하면 세금혜택도 있을까 	지하철 버스 세금혜택 여부	0
보험 약관 대출 받으면 얼마 정도 대출 받을 수 있을까 	보험 약관 대출 한도	2
여자친구랑 헤어진 지도 꽤 지났는데 좋은 사람 만났니 	좋은 사람 만났는지	0
주사님도 체육대회 참가 할 거예요 	체육대회 참가 여부	0
발표회 때 이 노래 부르기로 했어	발표회 때 이 노래 부르는지	0
그냥 우량주에 투자할까	우량주 투자할지	0
경제적 여유가 없을수록 보험이 필요해	경제적 여유가 없을수록 보험이 필요한지	0
열시 십분 비디오 녹화할까	열시 십분 비디오 녹화할지	0
주식가격변동이 기업가치에 미치는 영향이 큰가요	주식가격변동 기업가치 영향 큰지	0
차세대 선도 사업 기술 개발 사업의 아이템이 뭐죠	차세대 선도 사업 기술 개발 사업 아이템	2
왜 연락이 안돼 	연락 안되는 이유	2
실례합니다 서점이 어디지요	서점 위치	2
비상장 기업의 주식은 어떻게 사지	비상장 기업 주식 사는 방법	2
명상요가는 뭐가 달라	명상요가 다른 점	2
지방 내려간다더니 잘 다녀왔어	지방 잘 다녀왔는지	0
오늘 여섯시 이후 일정이 잡혀있어	오늘 여섯시 이후 일정 여부	0
학교에서 주최하는 토익 강좌는 들을만 할까 	학교 주최 토익 강좌 들을만 한지	0
반포대교 밑에 잠수대교가 침수 되었나요	잠수대교 침수 여부	0
덕전 로타리의 상태는 어때	덕전 로타리 상태	2
신도림 역에서 갈아 타고 가는 게 빨라	신도림 역에서 갈아 타고 가는 게 빠른지	0
급행 요금은 얼마에요	급행 요금	2
알코올은 운동을 해야 분해되는 거 아니야	운동 알코올 분해 여부	0
어떻게 된 거야	상황	2
거기 어떻게 가요	거기 가는 방법	2
다음 주 수요일 내 일정이 어떻게 되지	다음주 수요일 내 일정	2
아니 괜찮아	괜찮은지	0
부동산 시세와 관련된 기사는	부동산 시세 관련 기사	2
엄마 가방에 있던 돈 돌려줘야 할까 아님 그냥 넘어갈까 	엄마 가방 돈 돌려줄지 그냥 넘어갈지	1
사용료는 얼마지	사용료	2
교육심리학은 이번 학기에 꼭 들어야 한데	교육심리학 이번 학기 꼭 들어야 하는지	0
다른 건 알겠는데 삼일테크윈 주가 상승 원인을 모르겠어요	삼일테크윈 주가 상승 원인	2
은행에서 번호표 뽑고 있어	은행에서 번호표 뽑고 있는지	0
우리 오늘 약속 취소 됐대	오늘 약속 취소됐다는지	0
부대찌개에 넣을 재료 뭐 필요해	부대찌개 재료	2
그냥 목돈 만드는데 의의를 두는 거지	목돈 만드는데 의의 두는지	0
서울은 구름이 많이 꼈니	서울 구름 많은지	0
외국 계열의 보험회사가 괜찮다고 들었는데 어때	외국 계열 보험회사 괜찮은지	0
엄마가 용돈 안주신데	엄마가 용돈 안주시는지	0
투자자들의 반응은 어떤거 같아	투자자 반응	2
계좌이체하고 영수증은 잘 챙겼어 	계좌이체 영수증 챙겼는지	0
지금 서울의 습도는 얼마니	지금 서울 습도	2
아까 흥국생명 가서 교육보험 알아봤어	아까 흥국생명 가서 교육보험 알아봤는지	0
적립형 펀드가 더 효율적일까	적립형 펀드 효율 여부	0
수능의 어느 부분에 중점을 둬야 하는지	수능 중점 둘 부분	2
소주 한잔 하고 싶어 	소주 한잔 하고 싶은지	0
휴가철이 언제부터야	휴가철 시작 시기	2
참고 도서를 살까 그냥 복사 할까	참고 도서를 살지 그냥 복사할지	1
효진이는 우리 은행에 입사원서 냈어	효진이 우리 은행 입사원서 냈는지	0
고객예탁금도 주가와 관련이 있니 	고객예탁금 주가 관련 여부	0
우리들의 약속을 잊은 거야	약속 잊었는지	0
지분 몇 퍼센트 있는 사람이야	지분 퍼센트	2
현재 중부 상행선에서 교통이 통제되는 구간 어디니	현재 중부 상행선 교통 통제 구간 위치	2
사업 계획서는 어디에 제출하면 되죠	사업 계획서 제출 장소	2
용선 주변 휴대폰 대리점 어디래	용선 주변 휴대폰 대리점 위치	2
직불카드가 있으면 통장 없이도 출금할 수 있지	직불카드가 있으면 통장 없이도 출금할 수 있는지	0
대리운전 불러	대리운전 부를지	0
배가 언제 도착하지	배 도착 시간	2
수영장 있나요	수영장 있는지	0
서울역 근처 많이 가는 노래방은 어딘데	서울역 근처 많이 가는 노래방	2
기말에 중간고사 범위까지 포함해서 시험 봐 	기말 중간고사 범위 포함 여부	0
분당 근처 노래방 어딘데	분당 근처 노래방 위치	2
경부 고속도로 노면 결빙 구간 어딘데	경부 고속도로 노면 결빙 구간 위치	2
양성반응이면 당뇨병이래	양성반응이면 당뇨병인지	0
내일 물레과목 시험이야 	내일 물레과목 시험인지	0
이 줄은 뭐에요	줄 정체	2
아테네 올림픽 개막일이 언제인데	아테네 올림픽 개막일	2
구정 연휴에도 출근해	구정 연휴 출근 여부	0
지금 너 어디 있어	지금 위치	2
고구마 살까 으깬 감자로 할까	고구마 으깬감자 중 살 것	1
가을이라 이제부터 운동이라도 할까 하는 중이지 너는 뭐해 	지금 하는 것	2
명일동 부근 하이마트는	명일동 부근 하이마트	2
셰익스피어의 사대 비극이 뭔지 알아 	셰익스피어 사대 비극	2
현금카드가 직불카드의 기능도 해	현금카드 직불카드 기능 여부	0
요새 영화 촬영은 잘 돼가요 	영화 촬영 잘 돼가는지	0
서울에서 제일 안 아프게 치료하는 치과는 어떻게 가	서울에서 제일 안 아프게 치료하는 치과 가는 방법	2
장전동 부근 무료 신문 배포소는 어떻게 가니	장전동 부근 무료 신문 배포소 가는 방법	2
지하철 반대 방향으로 탔어	지하철 반대 방향으로 탔는지	0
통장 만들려면 뭐가 필요하지 	통장 만들려면 필요한 것	2
네 곁에 항상 있을게 눈은 다른 곳 봐도 되는 거지 	눈 다른 곳 봐도 되는지	0
대학 경쟁력 관련 특집기사는 뭔가	대학 경쟁력 관련 특집기사	2
오늘 온 편지 중 첨부 파일 든 편지는 얼마나 된데	오늘 온 편지 중 첨부 파일 든 편지 양	2
우리 회사 고용 변호사 바뀌었어	우리 회사 고용 변호사 바뀌었는지	0
필드에 한 번 나가면 캐디 비가 얼마쯤 들까	필드 캐디 비용	2
일반버스 요금도 이제 구백 원이래	일반버스 요금 구백 원인지	0
소액주주들을 배려하는 그런 주식회사 없나	소액주주 배려하는 주식회사	2
경남 마산에 수영장은 어딘데	경남 마산 수영장 위치	2
해외에서 국내 신용카드를 써도 되니 	해외에서 국내 신용카드 써도 되는지	0
갈수록 너무 예뻐지는 것 같더라 비결이 뭐니	갈수록 예뻐지는 비결	2
아이들도 건강하게 잘 크고 있지	아이들 건강하게 잘 크는지	0
몰라	모르는지	0
앞에 횡단보도에서 사고 났어	앞 횡단보도 사고 났는지	0
나 해외여행 가는데 면세점 갈 거야 뭐 필요해	면세점 필요한 것	2
다음달에 제사가 있어	다음달 제사 여부	0
경부 고속도로 노면 결빙 구간 어디지	경부 고속도로 노면 결빙 구간 위치	2
오늘 강우량이 얼마지	오늘 강우량	2
주식 회사 제도 어떻게 개혁해야 하는가	주식 회사 제도 개혁 방법	2
그쪽은 눈 많이 와요 	그쪽 눈 많이 오는지	0
이번 연휴가 며칠이나 되니	이번 연휴 기간	2
조류 독감이 우리 나라에서는 발병 안 했어	조류 독감 우리나라 발병 여부	0
우리 학교는 소풍 장소가 정해져 있어	우리 학교 소풍 장소 정해져 있는지	0
오늘 큰 아빠 수술 받으신데	오늘 큰 아빠 수술인지	0
내일 수업 시간표 어떻게 되지	내일 수업 시간표	2
그 카드에는 어떤 할인혜택이 있는데 	그 카드 할인혜택	2
학교 운동장에서 조기 축구해	학교 운동장에서 조기 축구하는지	0
한국 대표팀 축구 기사 있어	한국 대표팀 축구 기사	2
왜 보자고 하셨소 	보자고 한 이유	2
현관문이 얼마나 열려 있지	현관문 열려 있는 정도	2
이번에 스톡옵션을 많이 받았어	스톡옵션을 많이 받았는지	0
우리나라 지역별로 전운량은 얼마나 되나	우리나라 지역별 전운량	2
우리 그럼 몇 년 뒤에 만나는 거야	몇 년 후에 만날지	2
지금 긴급회의 소집 됐어요	긴급회의 소집 여부	0
내일 부산 지역 일출 일몰 시간 언제인가	내일 부산 지역 일출 일몰 시간	2
지금 연체 중이야	지금 연체 중인지	0
여기 책임자는 누구죠	여기 책임자	2
서울소재 외국어 고등학교는	서울소재 외국어 고등학교	2
학교는 산 근처라 아직 춥지	학교 아직 추운지	0
허브도 종류마다 효능이 달라	허브 종류마다 효능 다른지	0
오늘 방화 관련 기사가 뭐니	오늘 방화 관련 기사	2
나 호주로 유학 가려고 하는데 준비할 게 뭐가 있을까	호주 유학 준비물	2
시험 며칠 전부터 공부해야 할까	시험 공부 기간	2
무슨 대회라도 나가려고 하는 거야 	대회 나가는지	0
방송 출연 한다면서요 요즘 좋은 가 봐요	요즘 좋은지	0
오늘 오전 비올 확률은	오늘 오전 비 확률	2
농협 계좌 말고 다른 계좌 없어	농협 계좌 말고 다른 계좌	2
쇼핑몰안 스넥코너는 메뉴 다양해	쇼핑몰안 스넥코너는 메뉴 다양한지	0
얼음골은 어떻게 가야 하지	얼음골 가는 방법	2
십분내로 출발해	십분내로 출발할지	0
발행 유가 증권이 뭐니	발행 유가 증권 의미	2
쉬는 시간에 주로 뭘 하고 지내니 	쉬는 시간 주로 하는 것	2
비자 발급 비용은 얼마지	비자 발급 비용	2
졸업식에는 다들 사진 촬영만하고 가	졸업식 사진 촬영만하고 가는지	0
동대에서 가장 싼 술집은 어떻게 가니	동대 가장 싼 술집	2
자유롭게 저축하는 상품은 없나요 	자유롭게 저축하는 상품	2
왜 모두 은행에 다니면 이자부터 묻는 걸까 	은행 다니면 이자 묻는 이유	2
이번 주말의 날씨가 어떻지	이번 주말 날씨	2
창가 쪽 좌석을 원하십니까 복도 쪽 좌석을 원하십니까	창가 쪽 좌석 복도 쪽 좌석 중 원하는 것	1
과학 분야 특집기사는 뭔가	과학 분야 특집기사	2
우리 아들 백 일까지 남은 시간은	우리 아들 백 일까지 남은 시간	2
고모가 병원에 입원하셨어	고모 병원 입원하셨는지	0
로맨틱 코메디 영화 보고 싶어	로맨틱 코메디 영화 보고 싶은지	0
한 주 동안 그냥 휴가나 내서 푹 쉴래	한 주 동안 휴가 내고 쉴지	0
왜 이렇게 버스가 안 다니지 	버스 안 다니는 이유	2
어제는 왜 그렇게 일찍 들어갔어 	어제 일찍 들어간 이유	2
백화점의 하계 세일기간이 언제지	백화점 하계 세일기간	2
현관에 온 사람 몇 명이야	현관 온 사람 수	2
막내는 언제 집으로 돌아오니	막내 귀가 시간	2
안에는 뭐가 들었나요	안에 든 것	2
옛 생각에 뽑기 해 먹다가 혀 데였다며 괜찮아 	괜찮은지	0
체크카드로 인터넷 쇼핑 결제할 수 있어	체크카드 인터넷 쇼핑 결제 가능 여부	0
해동 검도로 다닐까 대한 검도로 다닐까	해동 검도 대한 검도 중 다닐 것	1
홍제 램프 부근의 시시티비로 찍은 정보도 볼 수 있니	홍제 램프 부근 시시티비 찍은 정보 볼 수 있는지	0
중국어 수업 수강신청일이 언제야	중국어 수업 수강신청일	2
이 서류 결재만 맡으면 되는 거지  	이 서류 결재만 맡으면 되는지	0
정말이야	정말인지	0
이 시간에 길이 왜 이렇게 막힐까	이 시간 길 막히는 이유	2
요새는 뭐하고 사는 거야 통 연락도 없고 학교에도 안 보이고	근황	2
퇴실은 언제하니	퇴실 시각	2
수도세 내는 날이 언제야	수도세 내는 날	2
기차가 버스보다 더 빨라	기차가 버스보다 빠른지	0
오늘 결재일 이야	오늘 결재일인지	0
자네는 우량주 위주로 가지고 있나 	우량주 위주로 가지고 있는지	0
교통법규는 잘 지키는 편이야	교통법규 잘 지키는 편인지	0
그런데 은행이 부도나면 내 돈은 어떡해	은행 부도나면 돈 어떻게 되는지	0
추계 학회 있다는 소식 들었나 	추계 학회 소식 들었는지	0
들꽃 사진 촬영할거야	들꽃 사진 촬영 여부	0
필라테스 하면 살 좀 빠질까	필라테스 살 빠질지	0
어디가 아픈 거야 내가 갈게	아픈 곳	2
여자 친구와는 잘되고 있는 거지	여자친구와 잘 되고 있는지	0
태풍이 밀려온다는 데 괜찮아	태풍 괜찮은지	0
너 네 회사 주로 어느 은행이랑 거래하니	회사 주거래은행	2
독립문은 뭐하는 곳이지	독립문 의미	2
일본은 지금 몇 시에요	현재 일본 시각	2
백화점에 아직 점포는 뚫지 못했어요	백화점 점포 여부	0
마스크 쓰고 나왔지 황사가 너무 심해	마스크 착용 여부	0
왜 걔한테 불똥이 튀었어	걔 불똥 튄 이유	2
여행스케치의 기분 좋은 상상이란 곡 어떠세요	여행스케치 기분 좋은 상상 어떤지	2
어학연수는 왜 실패하는가 	어학연수 실패 이유	2
오늘 종례는 별 내용이 없었어	오늘 종례 별 내용이 없었는지	0
경부 고속도로 노면 결빙 구간은 어떻지	경부 고속도로 노면 결빙 구간 상태	2
당뇨병에 좋은 음식이 뭐니	당뇨병에 좋은 음식	2
주차 문제가 신경 쓰이는데 거긴 주차할 때 많니 	거기 주차할 때 많은지	0
보험 가입 하면 뭐가 좋지 	보험 가입 장점	2
전화해	전화하는지	0
그 과목은 교재가 필요 없어	그 과목 교재 필요 없는지	0
지난달에 미용실에 간 날이 언제	지난달 미용실 간 날	2
오늘 새 편지 중 아이디 피그바라가 보낸 메일 몇 통이니	오늘 새 편지 중 아이디 피그바라가 보낸 메일 수	2
도대체 비자카드 마스터 카드는 무슨 카드야	비자카드 마스터 카드 정체	2
영국에서 유럽 본토로 들어갈 때 뭐 타고 갔었어	영국에서 유럽 본토로 들어갈 때 탄 것	2
내일 설계스튜디오 수업 인사동에서 한대요	내일 설계스튜디오 수업 인사동에서 하는지	0
그때 보고 정말 오랜만이네 잘 지내	근황	0
오늘의 주가 어떻지	오늘의 주가	2
포항에 정신과 어디 있는 줄 아냐	포항 정신과 위치	2
사랑하는 친구야 건강은 좀 호전 됐니 	건강 호전 여부	0
이백 번 버스 어디서 타야 돼	이백 번 버스 타는 장소	2
언제쯤 저녁 시간이 편하신가요	편한 저녁 시간	2
오늘 바람이 심하게 불던데 풍속이 얼마나 됐을까	오늘 풍속	2
이천 사년 유로 월드컵의 우승 팀에 대한 기사 어떤 내용이지	이천 사년 유로 월드컵 우승 팀 기사 내용	2
여기는 처음이신가요	여기 처음인지	0
퇴직할 때 주식을 주는 경우도 있대	퇴직할 때 주식 주는 경우도 있는지	0
육십 평대 통장은 프리미엄이 얼마에요	육십 평대 통장 프리미엄	2
서울대에서 서울역까지 흐름은 원활하냐	서울대에서 서울역까지 흐름 원활 여부	0
컴퓨터 고치러 몇 시에 오실 거예요	방문 시각	2
간접흡연도 폐암을 유발시켜 	간접흡연 폐암 유발 여부	0
경상도의 휴양림은	경상도 휴양림	2
너랑은 관계없는 일이야	관계없는지	0
오늘 학교 원서 내고 왔어	오늘 학교 원서 내고 왔는지	0
술 마셔서 위 아프다더니 약 챙겨 먹었어 	약 챙겨 먹었는지	0
물리치료 오래 받아야 되요	물리치료 오래 받아야 되는지	0
밥은 먹고 다니냐	밥 먹고 다니는지	0
그 공원에 가려면 다시 유턴해야 해	그 공원에 가려면 다시 유턴해야 하는지	0
올해는 알엔지 투자비가 어느 정도 책정됐습니까	올해 알엔지 투자비	2
오늘 연구실에 사람들 나와 있나요	연구실 사람들 나왔는지	0
무슨 집회 같은 걸 하나 	집회 같은 걸 하는지	0
행주대교 남단 교통 흐름이 어떤데	행주대교 남단 교통 흐름	2
이번 로또 배당금이 얼마야	이번 로또 배당금	2
본지 오래됐는데 뭐하고 지내니	근황	2
오늘의 환율변화는 어떤데	오늘 환율변화	2
그럼 잘되려면 무엇부터 해야 하죠	잘되려면 먼저 할 것	2
대연동 주변 찜질방 어떻게 가니	대연동 주변 찜질방 가는 방법	2
오토바이가 너무 사고 싶은데 위험할까	오토바이 위험 여부	0
네 친구 위암 말기라고 하던데 어떻게 할 거야 	위암 말기 대책	2
오늘 태풍주위보가 해제되니	오늘 태풍주위보 해제 여부	0
싱가폴 출장 일정이 어떻지	싱가폴 출장 일정	2
그건 교통카드로 못 타	그건 교통카드로 못 타는지	0
실례합니다 가장 가까운 신발 가게는 어디인가요	가장 가까운 신발 가게 위치	2
장학금 받으려면 성적이 얼마나 되야 하지	장학금 요구 성적	2
과연 올해 안에 천이백선 도달할 수 있을까 	올해 안 천이백선 도달 가능 여부	0
너 큰일이다 자꾸 왜 그래	그러는 이유	0
뮤츄얼펀드 매매가 가능해 	뮤츄얼펀드 매매 가능 여부	0
괜찮아요	괜찮은지	0
차도 막히는데 퀵서비스 이용해	퀵서비스 이용할지	0
오늘의 북한 소식은 뭐지	오늘 북한 소식	2
부산 명동칼국수는 어떻게 간데	부산 명동칼국수 가는 방법	2
설마 내일 비는 안오겠지	내일 비 올지	0
현진이 약혼식이 언제쯤이지	현진 약혼식	2
외국어 공부 하고 싶은데 일본어가 좋을까 아니면 중국어가 좋을까	일본어 중국어 중 좋은 것	1
회화를 다닐까 리스닝을 다닐까	회화 리스닝 중 다닐 것	1
수표로 드릴까요 현금으로 드릴까요	수표 술지 현금 줄지	1
당뇨병은 많이 좋아 지셨나요	당뇨병 호전 여부	0
화물의 추가 요금은 얼마인가요	화물 추가 요금	2
회사 나와서는 무슨 일을 계획하고 있는데 	회사 나와서 계획하고 있는 일	2
수학 교재 갖고 있을 만한 사람 또 없나요	수학 교재 갖고 있을 만한 사람 여부	2
오늘 전국 한낮의 체감온도는 어떻데	오늘 전국 한낮 체감온도	2
그래서 비행장마다 새 쫓는 사람들이 있어	비행장마다 새 쫓는 사람들이 있는지	0
벌금 매기면 애들 시간 맞춰서 나올까 	벌금 효과 여부	0
부산 동래파전 집이 어디지	부산 동래파전 집	2
맨 앞에서 탈까 맨 뒤에서 탈까 	맨 앞 맨 뒤 중 탈 곳	1
잘 지내냐	잘 지내는지	0
거기 어떻게 가요	거기 가는 방법	2
근데 이제야 왜 자전거를 배우려 하는데 	이제야 자전거 배우는 이유	2
그러면 내가 여덟시 반까지 가고 네시반에 끝내도 되요	내가 여덟시 반까지 가고 네시반에 끝내도 되는지    	0
우리나라의 국경일이 얼마나 있지	우리나라 국경일 수	2
부모님은 여행 잘 다녀오셨어	부모님 여행 잘 다녀오셨는지	0
조금 뒤에 있을 세미나 올 거지	세미나 올 건지	0
보낸 이메일 중 되돌아 온 이메일 몇 통인가	보낸 이메일 중 되돌아 온 이메일 수	2
여기서 대구까지는 정체 구간이니	대구까지 정체 구간 여부	0
이번 학기는 몇 학점을 들어야 할까 	이번 학기 학점 수	2
한 시간에 얼마에요	한 시간 가격	2
지금은 어떤 영화를 하나요	지금 하는 영화	2
현금 카드 하나 만드려고	현금 카드 하나 만드는지	0
철수는 어제 왜 숙제를 해 오지 않았지	철수 어제 숙제 해 오지 않은 이유	2
우대 금리를 주나요 	우대 금리 주는지	0
주택청약부금 들을라면 어떻게 해야하지	주택청약부금 드는 방법	2
겨울방학이 언제 쯤 끝날까	겨울방학 끝날 시기	2
오늘 내가 현철이에게 메일을 보냈니	현철이에게 메일 보냈는지	0
이번에 교양과목 뭐 들어 	이번 듣는 교양과목	2
신정은 무슨 요일이지	신정 요일	2
오늘 강수량이 얼마나 되니	오늘 강수량	2
그래 잘 도착 했어	잘 도착 했는지	0
인터넷에서 포토샵 배워 볼라고	인터넷에서 포토샵 배우는지	0
정기적금은 어느 은행이 괜찮을까	정기적금 괜찮은 은행	2
대구에 추나요법 잘하는 한의원 있어요	대구 추나요법 잘하는 한의원	2
서울에서 제일 안 아프게 치료하는 치과 어디야	서울 안 아프게 치료하는 치과	2
서울대 근처 많이 가는 맥주집은 어떻게 갈까	서울대 근처 많이 가는 맥주집 가는 방법	2
주식형과 채권형 중에 뭐가 더 좋을까 	주식형 채권형 중 좋은 것	1
입원하셨다더니 건강은 좀 어떠세요 	건강 어떤지	0
보낸 메일 중 되돌아 온 메일 몇 통이냐	보낸 메일 중 되돌아 온 메일 수	2
올해 윤달이 있니	올해 윤달 여부	0
창원시 반림동 소재 외과 병원은 어디야	창원시 반림동 소재 외과 병원	2
여기 지금 태풍 때문에 난리도 아니야 거긴 괜찮아	태풍 괜찮은지	0
보고서 발표 준비는 확실히 마무리 했니 	보고서 발표 준비 마무리 여부	0
이종격투기는 폭력일까 스포츠일까 	이종격투기 폭력인지 스포츠인지	1
타임캡슐을 묻었대	타임캡슐 묻었는지	0
부산 사직동에 고래고기 하는 집이 있나	부산 사직동 고래고기 집 여부	2
통합보험이랑 종신보험이랑 뭐가 다른지 알아	통합보험 종신보험 차이	2
넌 보통 눈 오는 날에는 뭐하니	보통 눈 오는 날 하는 일	2
다음 주 전국 예상날씨는 어떠니	다음 주 전국 예상날씨	2
유기농 샌드위치는 비싸	유기농 샌드위치 비싼지	0
어떠세요	어떤지	2
여름엔 뭐니 뭐니 해도 바비큐파티다 너도 올 거지	바비큐파티 올지	0
독후감 쓰기 대회에서 상 탔어	독후감 쓰기 대회 상 탔는지	0
열이 많이 나요	열이 많이 나는지	0
버티고개에서 전망이 제일 좋은 커피숍은 어떻게 갈까	버티고개 전망 좋은 커피숍 가는 방법	2
주식 시가는 어떻게 정해지는 거예요	주식 시가 정해지는 방법	2
경복궁에서 야외 수업이래	경복궁 야외 수업인지	0
대구의 기온이 몇 도일까	대구 기온	2
근데 어느 회사 꺼 사뒀는데	사 둔 회사	2
비데 무브 기능 작동해	비데 무브 기능 작동 여부	0
경부 고속도로에 노면이 결빙된 구간은 얼마나 되니	경부 고속도로 노면 결빙 구간 정도	2
오늘 시험 어떤 게 어려웠어	오늘 시험 어려운 것	2
주요 도시의 강수 분포도 얼마야	주요 도시 강수 분포도	2
결국 카드로 질러버렸다 수습이 안 되는데 어떻게 하지 	수습 방법	2
고교 동창회가 언제야	고교 동창회 날짜	2
윤범이는 오늘 어머니 생신이라 못 온데	윤범이 오늘 못 오는지	0
명동에서 연인들이 제일 많이 가는 레스토랑은 어딘데	명동 연인들 제일 많이 가는 레스토랑 위치	2
영화 볼까	영화 볼지	0
창문이 닫혀있니	창문 닫혀있는지	0
오전에 아침 식사 이외에 부가 서비스를 이용하셨나요	오전 아침 식사 이외 부가 서비스 이용 여부	0
지난 번에 했던 일 퇴짜 맞았어	지난 번 했던 일 퇴짜 맞았는지	0
다섯 시 이후면 아무 때나 괜찮아	다섯 시 이후면 아무 때나 괜찮은지	0
부산에서 제일 안 아프게 치료하는 치과는 어떻게 가냐	부산 안 아프게 치료하는 치과 가는 방법	2
삼계탕이 더 좋을까 보신탕이 더 좋을까 	삼계탕 보신탕 중 더 좋은 것	1
아시아나 운임은 얼마해	아시아나 운임	2
성수대교남단에서 도산사거리 사이 도로 정보는	성수대교남단에서 도산사거리 사이 도로 정보	2
좀 더 빠르게 습득할 방법이 없을까 	좀 더 빠르게 습득할 방법	2
고교 동창회가 언제야	고교 동창회 날짜	2
내일 눈 온데	내일 눈 오는지	0
점심 몇 시에 하실 거예요 	점심 시간	2
오늘 아침 안개가 끼냐	오늘 아침 안개 여부	0
식사 하셨어요	식사 여부	0
김치찌게 어때	김치찌개 어떤지	0
비행기편 변경 가능한가요	비행기편 변경 가능한지	0
어떤 예금으로 해야 좋을까요 	좋은 예금	2
게임 회사가 요즘에도 유망한 편이니 	게임 회사 유망 여부	0
어제 보낸 메일 중 수신 확인 안 된 메일은 얼마나 되나	어제 보낸 메일 중 수신 확인 안 된 메일 수	2
서울시내 어쭈구리 매장은 어떻게 간데	서울시내 어쭈구리 매장 가는 방법	2
메이크업을 배우고 싶은데 어느 학원이 유명하지 	메이크업 배울 만한 학원	2
예약금 걸 돈이 없는데 어쩌면 좋지	예약금 없을 때 대책	2
공항까지 가는 길이 많이 막히니	공항까지 가는 길 막히는지	0
정부가 이렇게 세율을 조정하려고 하는 이유는 뭐죠	정부 세율 조정 이유	2
스테미너 건강 관리법은 뭐가 좋지 	좋은 스테미너 건강 관리법	2
선생님 우리 내일 볼 수 있는 거예요 	내일 보는지	0
오번 버스 두 대 왔는데 두 번째 버스 탔어	오번 버스 두 번째 버스 탔는지	0
오늘 서울행 비행기에 좌석 있니	오늘 서울행 비행기 좌석 여부	0
오늘 내준 영어 단어 다 외웠니	오늘 내준 영어 단어 다 외웠는지	0
미 대학 럭비팀 관련 기사는	미 대학 럭비팀 관련 기사	2
부산 서울 간 비행기 요금 얼마야	부산 서울 간 비행기 요금	2
열쇠는 우편함에 넣어뒀지	열쇠 우편함에 넣어뒀는지	0
경록이 결혼일이 언제야	경록이 결혼일	2
답답해	답답한지	0
동호회에 대한 이메일 왔니	동호회 대한 이메일 왔는지	0
나올수 있어	나올수 있는지	0
네 친구 중에 포토샵 잘 다룰 줄 아는 친구 있어	포토샵 다룰 수 있는 친구 여부	0
카드연체 때문에 대출가능금액이 없대 	카드연체 때문에 대출가능금액이 없는지	0
이 호선 타면 돌아서 가는데 충무로 쪽으로 가는 게 빠를까 교대 쪽으로 가는 게 빠를까	충무로 쪽 교대 쪽 중 빠른 것	1
버티고개 근처에서 전망이 제일 좋은 커피숍은 어딘데	버티고개 근처 전망 제일 좋은 커피숍	2
토요일에 볼까 일요일에 볼까	토요일에 볼지 일요일에 볼지	1
여기 금방 뚫릴 것 같아	여기 금방 뚫릴지	0
경주에는 특상품 점 많아	경주 특상품 점 많은지	0
아직 멀었니 	아직 멀었는지	0
사 교시 수업은 영어로 바뀌었어	사 교시 수업 영어로 바뀌었는지	0
신용불량자가 되면 집에 가압류까지 들어오나	신용불량자가 되면 집에 가압류 들어오는지	0
금융 실명제를 최초로 시행한 나라는 어느 곳입니까 	금융실명제 최초 시행 나라	2
골프장 가는중	골프장 가는중인지	0
강남구에 경찰서가 어디에 있냐	강남구 경찰서 위치	2
한젬마 생각하며 찍은 거야	한젬마 생각하며 찍었는지	0
컴퓨터의 기초가 전공 필수 맞지	컴퓨터의 기초 전공 필수 여부	0
그날 잘 들어가서 쉬셨나요 	잘 들어가 쉬었는지	0
바다와 산 중에 어디 갈지 너가 골라	바다 산 중 갈 곳	1
내일 소개팅 시간이 몇 시지	내일 소개팅 시각	2
아직도 선생님 잘 계시니 찾아 봬야할텐데	선생님 잘 계시는지	0
회전율이랑 거래량 상위 종목 중에 눈에 띄는 종목 없니	회전율 거래량 상위 눈에 띄는 종목	2
시험이 어려웠어	시험이 어려웠는지	0
통장 만들려면 뭐뭐 필요해 	통장 만들려면 필요한 것	2
일 층에 화장실 생겼어	일 층 화장실 생겼는지	0
내일 약속있나	내일 약속 여부	0
고평가된 주식의 가능성은 어느 정도지	고평가 주식 가능성	2
내일 못 간데	내일 못 가는지	0
그 외에 다른 물품은 없나요	다른 물품 여부	0
주기 싫어	주기 싫은지	0
수정이 한테 메일 왔니	수정이한테 메일 왔는지	0
아령 몇 키로가 적당한 거니	적당한 아령 무게	2
이번 추석에 뭐 타고 내려갈 거야 	이번 추석 타고 내려갈 것	2
다음 주 화요일의 서울 날씨는 어떨가	다음 주 화요일 서울 날씨	2
증권사들이 향후 전망이 갑자기 비관적이 된 이유가 뭐죠	증권사 향후 전망 비관적인 이유	2
미희 출장을 영욱으로 간데	미희 출장 영욱 가는지	0
학습 능력 개발원이라는 곳이 있다는데 한 번 가볼 생각 있어 	학습 능력 개발원 가볼 생각 있는지	0
현재 완제품 재고량이 얼마나 되죠	현재 완제품 재고량	2
콜금리 인상이 과연 어떻게 영향을 줄지	콜금리 인상 영향 주는 방식	2
같이 해외여행 가자고 해서 돈 모으는 중인데 너는 어때 	해외여행 돈 모으기 상황	2
독감 걸려서 병원에 입원 했어	독감 걸려 병원 입원 했는지	0
철도청 홈페이지로 가서 예약하면 돼	철도청 홈페이지로 가서 예약하면 되는지	0
주식투자 시 부모님의 동의가 필요하나요 	주식투자 시 부모님 동의 필요 여부	0
시골집에 갔다 오려고 하는데 뭐 타고 갈 거니 	시골집 타고 갈 것	2
내년 추석 예상 날씨가	내년 추석 예상 날씨	2
메이크업을 배우고 싶은데 어느 학원이 유명하지 	메이크업 배울 만한 유명한 학원	2
한가해	한가한지	0
이대 앞에서 연대 앞으로 아직도 차가 많이 밀리나	이대 앞에서 연대 앞으로 차 밀리는지	0
택배 부칠 때 컴퓨터는 따로 말해서 배송해야 돼	택배 부칠 때 컴퓨터 따로 말해야 되는지	0
부산에 있는 해수욕장의 현재 기온은 얼마나 되니	부산 해수욕장 현재 기온	2
다음 주 포항의 날씨는	다음 주 포항 날씨	2
지하철을 타고 가는 게 빠를까요	지하철 빠를지	2
왜 이렇게 전화를 안받아	전화 안 받는 이유	2
여기가 시내로 가는 버스 정류장인가요	여기가 시내로 가는 버스 정류장인지	0
요즘 건강은 어떠세요	요즘 건강 괜찮은지	0
팩스를 어디서 보낼 수 있을까요	팩스 보내는 곳	2
신림동의 휘트니스 클럽이 잘 지도 해 준데	신림동 휘트니스 클럽 잘 지도 해주는지	0
프로젝트 이번 주까지 되지	프로젝트 이번 주까지 가능 여부	0
태국과 필리핀 중 어느 상품이 더 저렴하나	태국 필리핀 중 상품 저렴한 곳	1
기차표 열시쯤 출발하는 표 사	열시쯤 출발하는 표 살지	0
잡지 읽고 있어	잡지 읽고 있는지	0
요즘 달러 환율 얼마야	요즘 달러 환율	2
현재 중부 상행선에서 교통이 통제되는 구간은 얼마나 될까	현재 중부 상행선 교통 통제 구간	2
월요일과 화요일 중에 언제 만날래	월요일 화요일 중 만날 때	1
성적 언제 발표 된데	성적 발표 시기	2
주가 떨어진다는데 팔거야 말거야	주식 팔지	0
경부 고속도로 갈 건데 지금 교통상황은 어때	경부 고속도로 교통상황	2
회계 원리 백 쪽 사번 문제 어떻게 푸는지 알아 	회계 원리 백 쪽 사번 문제 푸는 방법	2
간단히 할 수 있는 사업 뭐가 있지	간단히 할 수 있는 사업	2
공항에 픽업 나가야 되요	공항 픽업 나가야 되는지	0
너희 학교 수강신청 온라인으로 하지	수강신청 온라인으로 하는지	0
이 테이블 괜찮으세요	이 테이블 괜찮은지	0
일본은 지금 몇 시에요	지금 일본 시각	2
시간 오후 세시이래	시간 오후 세시인지	0
새 편지 중 성인광고 단어가 든 메일은 얼마나 되니	새 편지 중 성인광고 단어 든 메일 수	2
최근 세계 증시의 공통된 관심사가 과연 뭘까 	최근 세계 증시 공통 관심사	2
우리 이번 주 금요일에 보는 거지 	이번 주 금요일 보는지	0
영화 펀드로 재미 본 사람 많았어	영화 펀드로 재미 본 사람 많았는지	0
이천 사년 팔월 십오일이 무슨 요일이지	이천사년 팔월 십오일 요일	2
신문 대금 수금일이 언제지	신문 대금 수금일	2
브이자 반등을 기대해도 될까 	브이자 반등 기대해도 될지	0
경부선 정체구간은 어떻데	경부선 정체구간 상황	2
카드 중지 됐어	카드 중지 됐는지	0
이건 어디 제품이죠	어디 제품인지	2
노후 자금의 규모는 어느 정도가 적당할까 	노후 자금 규모	2
라식 수술은 회복이 빠르다지만 눈이 좀 시리다던데 괜찮니  	눈 괜찮은지	0
올해 추석 전국 예상 날씨는 어때	올해 추석 전국 예상 날씨	2
부동산 정책 관련 기사는	부동산 정책 관련 기사 여부	0
올해 태풍이 얼마나 많이 올까	올해 태풍 얼마나 올지	2
순수 주식이랑 예금형 주식이랑 동시에 투자하는 것이 좋아	순수 주식 예금형 주식 동시 투자 좋은지	0
공제금 지급이 안 되는 경우도 있나요 	공제금 지급 안 되는 경우 있는지	0
상견례 장소로 어디가 좋아	상견례 좋은 장소	2
수요일 꽃꽂이 레슨은 언제 시작하지	수요일 꽃꽂이 레슨 시작 시간	2
올해 구정은 언제지	올해 구정 날짜	2
넌 주말인데 집에서 뭐하냐 	집에서 하는 것	2
초밥요리사랑 결혼하는 건 어때	초밥요리사랑 결혼 어떤지	0
어젯밤 내가 누구에게 이메일을 보냈니	어젯밤 내가 이메일 보낸 사람	2
그래서 원론 뺀 애들 많아	원론 뺀 애들 많은지	0
교과서에서만 출제하신다는데 교과서 위주로 공부해	교과서 위주로 공부할지	0
웨이트트레이닝은 정말 싫어	웨이트트레이닝 싫은지	0
공주까지 시외버스 요금은 얼마야 	공주까지 시외버스 요금	2
나 지금 출발하려고 하는데 버스가 빠를까 지하철이 빠를까	버스 지하철 중 빠른 것	1
그냥 사무 관리직이야 너는 	그냥 사무 관리직인지	0
뭐 먹을까	먹을 것	2
택배 부칠 때 컴퓨터는 따로 말해서 배송해야 돼	택배 부칠 때 컴퓨터 따로 말해서 배송해야 되는지	0
서울 근교 놀이공원은 어디냐	서울 근교 놀이공원	2
정말 보고 싶을까	정말 보고 싶을지	0
이틀이요	이틀인지	0
인천 국제공항 고속도로 구간의 교통 흐름은	인천 국제공항 고속도로 구간 교통 흐름	2
여자 친구와 배드민턴은 어때	여자친구와 배드민턴 상황	2
거기 가려면 몇 호선 타야 돼 	거기 가려면 타야 되는 호선	2
지난주에 종합주가지수가 몇 포인트나 상승됐는지 알아 	지난주 종합주가지수 상승 포인트	2
이번에 새로 뚫린 길 달려봤어	새로 뚫린 길 달려봤는지	0
서울에 할인점 많아	서울에 할인점 많은지	0
올해 우리 아버지 생신이 무슨 요일인데	올해 우리 아버지 생신 요일	2
보통주와 우량주의 차이점이 뭐야 	보통주 우량주 차이점	2
오늘의 포인트 동향은 좀 어떤 것 같아 	오늘 포인트 동향	2
바이오테크 업종이 많이 올랐어	바이오테크 업종 많이 올랐는지	0
가격 비교 사이트 운영은 어때 	가격 비교 사이트 운영 어떤지	2
서울 명동 근처 매운탕 집 어디에 있니	서울 명동 근처 매운탕 집 위치	2
다음주에 일제잔재문화유산답사 있대 	다음주 일제잔재문화유산답사 있는지	0
우리 내일 놀러 갈때 버스탈까 기차타고 갈까	버스 기차 중 내일 놀러갈 때 탈 것	1
명동에서 연인들이 제일 많이 가는 레스토랑은 어딘데	명동 연인들 제일 많이 가는 레스토랑	2
내일부터 자율 십부제 운행한다던데 넌 내일 쉬는 날이지	내일 쉬는 날인지	0
괜찮니	괜찮은지	0
영어시험은 선생님따라 문제 다른 거 아니지	영어시험 선생님 따라 문제 다른지	0
곧 유학 간다더니 준비는 잘 돼가니 	유학 준비 잘 돼가는지	0
뉴욕 증시는 하락세야	뉴욕 증시 하락세인지	0
새 편지 중 정보라는 단어가 든 메일 얼마나 돼	새 편지 중 정보라는 단어 든 메일	2
적립형 펀드가 더 효율적일까	적립형 펀드 효율적일지	0
오늘 모임에 참석할 건가요	오늘 모임 참석 여부	0
저 구석으로 가 있어	저 구석으로 가 있을지	0
어젯밤 이메일 중 첨부 파일 든 이메일 얼마나 되냐	어젯밤 이메일 중 첨부 파일 든 이메일 수	2
주식과 펀드의 차이점이 뭐죠	주식 펀드 차이점	2
자가용으로 가면 밀양까지 얼마나 걸릴까	자가용 밀양까지 걸리는 시간	2
지윤이 학예회 발표일이 언제야	지윤이 학예회 발표일	2
서울에서 언제 출발이래	서울 출발 시각	2
현관에 온 사람이 있지	현관 온 사람 여부	0
학원 다니는 게 나을까 과외 나을까 	학원 과외 중 나은 것	1
혈압 약은 거르지않고 잘 드시고 있나요	혈압 약 잘 먹고 있는지	0
국어수업시간이 이번 주에 몇 번있지	국어수업시간 이번 주 횟수	2
우리 사귈래	사귈지	0
고객 예탁금이 얼마나 돼	고객 예탁금	2
반신욕 하면 살 빠진데	반신욕 하면 살 빠지는지	0
정말 아프니	정말 아픈지	0
가는길 몰라	가는길 모르는지	0
사고 난거는 잘 해결 됐어	사고 난거 잘 해결 됐는지	0
오늘의 습도 얼마지	오늘 습도	2
프랑스의 오늘 최저 기온이 얼마나 기록됐지	프랑스 오늘 최저 기온	2
예약에 잡힌시간은 언제야	예약 시간	2
수영 하면 진짜 어깨가 넓어져	수영 하면 진짜 어깨가 넓어지는지	0
동의대 주변 플레이스테이션 방은 어디냐	동의대 주변 플레이스테이션방 위치	2
은행의 대출한도가 어느 정도인지 혹시 아니 	은행 대출한도	2
교과서가 얼마죠 요즘 책 값이 너무 비싸요	교과서 가격	2
당뇨병은 식이요법으로 치료할 수밖에 없대	당뇨병 식이요법으로 치료할 수밖에 없는지	0
우리 과 졸업 이수 학점이 몇 학점인지 아니	우리 과 졸업 이수 학점	2
소비자들의 소비 패턴을 분석하고 있어	소비자 소비 패턴 분석하는지	0
그게 주가에 영향을 주려나	그게 주가 영향 주는지	0
동서대 주변에 파마 제일 잘하는 미용실은 어떻게 가냐	동서대 주변 파마 제일 잘하는 미용실 가는 방법	2
지금 거기 갈까	지금 거기 갈지	0
그 다이어트 식품 효과 있니	그 다이어트 식품 효과 여부	0
해외 펀드 종류는 다양한 편이니 	해외 펀드 종류 다양한지	0
어느 외국어를 배워야 할까 	배울 만한 외국어	2
오늘 네시에 모임장소가 어디니	오늘 네시 모임장소	2
어제 과음을 했더니 위가 너무 쓰라려 약 집에 없어 	과음할 때 먹는 약 집에 있는지	0
서강대 주변 플스방 어떻게 가지	서강대 주변 플스방 가는 방법	2
남산공원 근처 편의점은 어디니	남산공원 근처 편의점	2
어제 마감 주가가 어떻게 되니	어제 마감 주가	2
종이로는 잘 효과가 안나	종이로 잘 효과 안나는지	0
간만에 연락드리는데 요새는 뭐 하세요 	근황	2
사장님께 사업계획서 제출 했어 	사장님께 사업계획서 제출 했는지	0
성탄절 카드를 보냈는데 받았니 	성탄절 카드 받았는지	0
자유수영으로 바꾸고 나서 한 번도 안 갔어	자유수영으로 바꾸고 나서 한 번도 안 갔는지	0
더 이상 생각하기 싫어	더 이상 생각하기 싫은지	0
오늘 전남지역 지역 구름의 양은 어떻데	오늘 전남지역 구름의 양	2
찝찝해	찝찝한지	0
시내버스 안에서도 안전벨트 매게 하면 좀 안전할까 	시내버스 안에서도 안전벨트 매게 하면 안전할지	0
다음달 기일이 언제지	다음달 기일	2
칠월 구일이 마지막 휴가날이야	칠월 구일 마지막 휴가날인지	0
내일이 내 월급날인가	내일 내 월급날인지	0
김해 공항 진입로가 막히니	김해 공항 진입로 막히는지	0
교회에 가고 있어	교회 가고 있는지	0
버스와 기차 중 어느 것을 타고 여행합니까	버스 기차 중 타고 여행할 것	1
주식에는 손대지 않는 것이 낫다고들 하는데 왜 그런거죠	주식 손대지 않는 것이 낫다고 하는 이유	2
문화원 수업 신청했어	문화원 수업 신청했는지	0
외국인 보유주식의 시가총액이 얼마나 되는지요	외국인 보유주식 시가총액	2
그리스 모린의 방한 일정 관련 기사는	그리스 모린 방한 일정 관련 기사	2
우리 언제나 되야 만날 수 있을까 수다 떨고 싶어 	만날 수 있을 시기	2
병목 정체를 보이는 구간은 어디지	병목 정체 보이는 구간	2
요즘 소비자들의 소비의 패턴은 어때 	요즘 소비자들 소비 패턴	2
한문을 잘 외우는 방법은 없을까 	한문 잘 외우는 방법	2
석이 결혼식 어디서 하지	석이 결혼식 장소	2
수업 두 시간만 하고 끝난데	수업 두 시간만 하고 끝나는지	0
근데 공인인증서 발급받으러 가기 귀찮아	공인인증서 발급받으러 가기 귀찮은지	0
지금 쫌 빨리 가는 방법이 없을까	지금 쫌 빨리 가는 방법	2
경제학입문 수업 어려워	경제학입문 수업 어려운지	0
내일 하도급 계약자랑 약속이 되어 있니	내일 하도급 계약자 약속 여부	0
은옥이 안온다고 조금 아까 연락 왔는데 너는 어디쯤이야	지금 위치	2
홍은동 녹번역 구간 교통상황은 어떤데	홍은동 녹번역 구간 교통상황	2
어디서 머무르실 거에요	머무를 장소	2
아직도 산꼭대기는 눈 쌓여있어	산꼭대기 눈 쌓여있는지	0
은행에서 방카슈랑스 상품에 가입하면 우대 금리를 주나요 	은행 방카슈랑스 상품 가입 우대 금리 여부	0
이 열차는 몇 번 플랫폼에서 출발해요	열차 출발 플랫폼	2
오늘은 셔틀버스 운행 안 하는 날이야	오늘은 셔틀버스 운행 안 하는지	0
대구에도 지하철 있지 몇 호선까지 있어 	대구 지하철 호선 수	2
너 어제 술 많이 먹던데 속 괜찮아 	속 괜찮은지	0
무통장 입금하면 수수료 없어	무통장 입금 수수료 여부	0
가짜 수표인 줄 몰랐어	가짜 수표인 줄 몰랐는지	0
성수대교 남단에서 도산사거리 사이 도로 정보는	성수대교 남단에서 도산사거리 사이 도로 정보	2
이번에 이사님 새로 취임했어	이사님 새로 취임했는지	0
내가 어젯밤 현민이에게 보낸 이메일 제목이 뭐니	어젯밤 현민이에게 보낸 이메일 제목	2
일은 볼 수 있을까	일 볼 수 있을지	0
여행자수표가 나을까 현금이 나을까	여행자수표 현금 중 나은 것	1
우리나라 각 야구팀별 성적과 관련된 기사는 없을까	우리나라 각 야구팀별 성적 관련 기사	2
비 온다고 일기예보 나왔어	비 온다고 일기예보 나왔는지	0
너 현금서비스 얼마까지 받을 수 있어	현금서비스 한도	2
과음하시더니 속은 좀 어떠세요 	속 괜찮은지	0
매체별 주요 뉴스는 뭐니	매체별 주요 뉴스	2
요요현상이 없는 다이어트가 있을까요	요요현상 없는 다이어트	2
서면 소재 백화점은 어디래	서면 소재 백화점 위치	2
스위스 은행에 맡겨버릴까	스위스 은행에 맡길지	0
주식투자로 과연 돈을 벌 수 있나	주식투자로 돈 벌 수 있는지	0
어젯밤 나리에게 메일이 왔나	어젯밤 나리 메일 왔는지	0
오늘 왜 아는 척도 안했어 	오늘 아는 척 안한 이유	2
둘째누나 결혼식이 언제야	둘째누나 결혼식	2
여름방학은 언제 쯤 시작이야	여름방학 시작 시기	2
여자친구랑 아직도 사귀니 	여자친구 아직 사귀는지	0
관광 버스가 있나요	관광 버스 여부	0
오늘 컨디션은 괜찮아 	오늘 컨디션 괜찮은지	0
음력으로 오늘이 며칠이야	오늘 음력 날짜	2
어제 합격했다고 연락 왔어	어제 합격 연락 왔는지	0
오늘이 며칠이지	오늘 날짜	2
지금 바빠	지금 바쁜지	0
그날 말고	그날 아닌지	0
거래처에 임시 휴업 하는 거 연락해줬어	거래처 임시 휴업 하는 거 연락해줬는지	0
폐업된 법인을 다시 살리려고 하는데 혹시 어떡하는 지 알아	폐업된 법인 살리는 방법	2
서울에서 언제 출발이래	서울 출발 시각	2
수술 후유증은 없을까 	수술 후유증 여부	0
내일 경포도 앞바다 파도의 높이가 얼마나 될까	내일 경포도 앞바다 파도 높이	2
막내의 방학은 며칠부터 시작하니	막내 방학 시작일	2
첫 월급 타면 부모님께 뭘 사드릴까 	첫 월급 타면 부모님께 사드릴 것	2
오늘 청주지역의 구름양이 어떻게 되지	청주지역 구름양	2
전부 외웠어	전부 외웠는지	0
타 은행으로 인터넷 뱅킹할 때 수수료 얼마 붙는지 알아 	타 은행으로 인터넷 뱅킹 수수료	2
오랜만에 모임인데 왜 파토가 났어	모임 파토 이유	2
명동 소재 백화점은 어디더라	명동 소재 백화점 위치	2
너 지난번에 복용했던 약 효과가 있었어	지난번 복용 약 효과 여부	0
아버지께서 명예퇴직 하셨어	아버지 명예퇴직 하셨는지	0
어젯밤 내가 현민이에게 이메일을 보냈니	어젯밤 내가 현민이에게 이메일 보냈는지	0
우리나라 총 주식시장의 규모는 얼마입니까	우리나라 총 주식시장 규모	2
열차표 다섯 장 예매했어	열차표 다섯 장 예매했는지	0
올해 한국어 정보처리 학회가 언제쯤 시작인데	올해 한국어 정보처리 학회 시작 일시	2
요새 전자 쪽에 투자하는 게 좋을까	전자 쪽 투자 좋을지	0
학교 약국 지금 열었을까	학교 약국 지금 열었을지	0
어제 서울지역 구름의 양이 어땠지	어제 서울지역 구름 양	2
언제가 우리 부모님 결혼기념일이지	우리 부모님 결혼기념일	2
이건 어디서 만들어졌나요	이것 만들어진 곳	2
지금 틀까 아니면 기다릴까 	지금 볼지 기다릴지	1
현재 경부 고속도로의 날씨는	현재 경부 고속도로 날씨	2
동생방에 동생들이 있니	동생방 동생들 있는지	0
요즘 너희 쪽 사업은 잘되어가고 있어 	요즘 사업 잘되는지	0
요즘 개봉한 영화 중에서 뭐가 제일 재밌니 	최근 개봉 재밌는 영화	2
면접을 잘 봐야 합격이 유리하데	면접 잘 봐야 합격 유리한지	0
여의도로 자전거 타러 갈까	여의도 자전거 타러 갈지	0
부산에서 분위기가 제일 좋은 호텔 바는 어떻게 갈까	부산 분위기 제일 좋은 호텔 바 가는 방법	2
기차는 정시에 도착하나요	기차 정시 도착 여부	0
해운대 부근 문화쎈타 어떻게 가는가	해운대 부근 문화쎈타 가는 방법	2
우리 아들 백 일이 언제지	우리 아들 백 일 날짜	2
세탁기 꺼	세탁기 끄는지	0
돈이 적니	돈 적은지	0
서울 종로에서 분위기가 제일 좋은 째즈빠는 어디냐	서울 종로 분위기 좋은 째즈빠	2
카드 값 어떻게 막지	카드 값 막는 방법	2
정비소에 맡긴 자동차를 언제 찾아야 하지	정비소 자동차 찾을 시기	2
여의도로 벚꽃구경 갈 거야	여의도 벚꽃구경 갈지	0
에이티엠에서 다른 은행으로 계좌 이체하면 수수료 붙지	에이티엠에서 다른 은행 계좌 이체 수수료 여부	0
그냥 삐끗한 게 아닌 거 같은데 엑스레이 찍어봐	엑스레이 찍어볼지	0
왜 바닷가에는 눈이 잘 안오는 걸까 	바닷가 눈 잘 안오는 이유	2
오래 찾아뵙지 못했지만 편안히 지내시죠 	편안히 지내는지	0
왜 약속할 때는 손가락을 걸까 	약속 손가락 거는 이유	2
내일 차로 갈 건데 도로 여건이 어떨지 모르겠네	내일 도로 여건	2
어머니의 귀가 시간이 몇 시야	어머니 귀가 시각	2
홍대 근처 순두부 전문점은 어디일까	홍대 근처 순두부 전문점 위치	2
자동차 유지비가 많이 들어	자동차 유지비 많이 드는지	0
이번 주말에 레스토랑 예약해 놨어	이번 주말 레스토랑 예약 여부	0
사업장 위치는 선정했어 	사업장 위치 선정 여부	0
병원에는 무슨 일로 입원하셨어요	병원 입원 이유	2
고속도로와 국도중 어느 것이 좋을까	고속도로 국도 중 좋은 곳	1
업무 규정은 숙지하고 있는 거야  	업무 규정 숙지 여부	0
비정규직도 신용카드 발급이 가능한가요 	비정규직 신용카드 발급 가능 여부	0
오늘 온 편지 중 첨부 파일 든 편지는 몇 통이냐	오늘 온 편지 중 첨부 파일 든 편지 수	2
분반 테스트 결과 어떻게 나왔어	분반 테스트 결과	2
골프장 가는중	골프장 가는중인지	0
버스체계 개편이 교통사고 예방에 도움이 될까 	버스체계 개편 교통사고 예방 도움 될지	0
주임님 커피 한 잔 하실래요	커피 한 잔 할지	0
낙성대 근처 가장 싼 음식점은 어디지	낙성대 근처 가장 싼 음식점	2
교보문고에서 뭐 살건데	교보문고 살 것	2
현관 자물쇠가 잠겨 있니	현관 자물쇠 잠겨 있는지	0
저번에 스쳐지나가서 인사를 못했는데 요샌 뭐하고 지내 	근황	2
잠실에서 신길까지 길이 어떤데	잠실에서 신길까지 길 상황	2
부정행위 한 학생이 누구야	부정행위 한 학생	2
일 층에 화장실 생겼어	일 층 화장실 생겼는지	0
해외 송금 아무 은행에서나 가능한 거니	해외 송금 아무 은행에서나 가능한지	0
서강대 주변 플스방 어떻게 가지	서강대 주변 플스방 가는 방법	2
요번 주 전국 날씨 어떻게 되지	요번 주 전국 날씨	2
강남역 근처 게임방은 어디더라	강남역 근처 게임방 위치	2
현대 백화점에서 쇼핑 할 예정이야	현대 백화점 쇼핑 할 예정인지	0
난 요새 늘 놀기만 하는데 넌 뭐하니	근황	2
보스턴까지 왕복표는 얼마에요	보스턴 왕복표 가격	2
부모님도 잘 지내고 계시지	부모님 잘 지내시는지	0
부산 해운대 해수욕장 개장이 언제일까	부산 해운대 해수욕장 개장일	2
여윳돈 있으면 너도 주식이나 한 번 해볼래 	주식 해볼지	0
뭐야 왜 연락 안 하는데	연락 안 하는 이유	2
안 잊어 버렸어	안 잊어 버렸는지	0
스즈키 씨를 호출하셨나요 호텔 어딘가에 계실 텐데요	스즈키 호출 여부	0
지하철이나 버스 이용 하면 세금혜택도 있을까 	지하철 버스 이용 세금혜택 여부	0
상사에 어떻게 말씀 여쭐지 모르겠습니다	상사 말씀 여쭈는 방법	2
오늘 헤드라인 기사는 뭐지	오늘 헤드라인 기사	2
모의고사 사회 탐구 영역 채점 했어	모의고사 사회 탐구 영역 채점 여부	0
오늘 온 편지 중 첨부 파일이 든 편지 몇 통일까	오늘 온 편지 중 첨부 파일이 든 편지 수	2
너 이번이 마지막 학기인데 졸업하고 뭐 할 생각이야 	졸업하고 할 것	2
내일이 로또방송 하는 날인가	내일 로또방송 여부	0
주식 관리를 어떻게 하면 효율적으로 할 수 있을까요	효율적 주식 관리 방법	2
스쿠터는 면허 없이도 운전할 수 있어	스쿠터 면허 없이 운전 가능한지	0
오늘 새 편지 중에 정보라는 단어가 든 메일이 있냐	오늘 새 편지 중 정보라는 단어 든 메일 수	2
현재 원효대교 북단은 교통 원활하데	현재 원효대교 북단 교통 원활 여부	0
서울 근교의 놀이공원 어디냐	서울 근교 놀이공원	2
지금 퇴근	지금 퇴근하는지	0
주식 투자 해 보려는데 얼마쯤 하는 게 좋을까	주식투자 얼마나 할지	2
선약이 있어	선약 있는지	0
몇 시에 도착할 예정이니	도착 시간	2
내일이 무슨 달이지	내일 무슨 달인지	0
비가 올까 아니면 맑을까	비가 올지 맑을지	1
종로 근처에 있는 찜질방은 어떻게 가냐	종로 근처 찜질방 가는 방법	2
사업 물려받기로 했데 	사업 물려받기로 했는지	0
이번 주 금요일에도 회의 시간은 변함없지 	이번주 금요일 회의 시간 변동 여부	0
자기앞 수표랑 가계 수표가 어떻게 다른 거예요	자기앞 수표 가계 수표 차이점	2
아들아 과외 한 번 받아 볼래	과외 받아 볼지	0
비 와서 오늘 체육대회 연기 됐대	체육대회 연기 여부	0
배 괜찮아	배 괜찮은지	0
디지털 카메라는 남대문에서 사는 게 좋데	디지털 카메라 남대문에서 사는 게 좋은지	0
너 요가 해서 효과 좀 봤냐 	요가 효과 여부	0
귀여운 강아지는 데리고 왔어	귀여운 강아지 데리고 왔는지	0
업무 안내는 제대로 되는 거야	업무 안내 제대로 되는지	0
뭐하고 지내느라 연락도 안하냐	근황	2
어제 보낸 메일 중 수신이 확인된 메일 얼마나 돼	어제 보낸 메일 중 수신이 확인된 메일 수	2
언어 영역 교육 방송 시간이 언제지	언어 영역 교육 방송 시간	2
요즘에도 자전거타고 학교 다니는 거야 	자전거타고 학교 다니는지	0
엄마 내일 퇴원하실 때 같이 가줄까	내일 같이 가줄지	0
서울 종로구에 영양탕 하는 집이 있나	서울 종로구 영양탕 집 여부	0
거래 방법은 모의투자의 방식하고 똑같아	거래 방법 모의투자 방식과 같은지	0
사인회 삼일 뒤로 연기했어	사인회 삼일 뒤로 연기했는지	0
독도에 강풍 주의보가 발효됐니	독도 강풍 주의보 발효 여부	0
스키보드랑 숏 스키가 다른가요 	스키보드 숏 스키 차이점	2
보험 약관 대출 받으면 얼마 정도 대출 받을 수 있을까 	보험 약관 대출 한도	2
사기 도박단 관련 기사는	사기 도박단 관련 기사	2
교통사고 후유증의 의료비 유효기간이 있나요	교통사고 후유증 의료비 유효기간	2
내일 수도권 지역 비 올 확률이 어떠니	내일 수도권 지역 비 올 확률	2
해외 투자에 따르는 추가적 위험은 뭐라고 생각해 	해외 투자 추가적 위험	2
주가 변동성 완화 제도의 취지가 뭐라고 생각하십니까 	주가 변동성 완화 제도 취지	2
후배들과 약속이 몇 시야	후배들 약속 시각	2
그 은행에 가면 주민번호를 불러 줘야 해	그 은행에 가면 주민번호 불러 줘야 하는지	0
올해 여름이 더울까	올해 여름 더울지	0
곧 시작할 것 같아	곧 시작할 것 같은지	0
넌 도대체 연락도 없이 뭐하고 지냈냐	근황	2
지금 텔레비전 앞에 앉아있는 사람이 누구야	텔레비전 앞 사람	2
경부 고속도로 사고 난 데 있니	경부 고속도로 사고 여부	0
오늘 점심 약속 아직 유효한 거지 	오늘 점심 약속 유효 여부	0
요즘 건강팔찌가 유행이던데 그거 효과 있는 거야	건강팔찌 효과 여부	0
뉴욕 증시 마감 시황이 궁금해	뉴욕 증시 마감 시황	2
오늘이 로또 발표하는 날인가	오늘 로또 발표날인지	0
이 약 효과가 확실한 거죠 	약 효과 확실한지	0
내년 설 연휴가 며칠이니	내년 설 연휴 일수	2
조만간 한번 볼까	조만간 한번 볼지	0
내일이 내가 발표할 차례인 거지 	내일 내 발표 차례 여부	0
수수료가 붙어	수수료 여부	0
원효대교 소통 어때	원효대교 소통	2
동해 바다로 떠나는 거야	동해 바다로 떠나는지	0
광주의 특산품이 뭐니	광주 특산품	2
은행의 업무를 맡는 사람을 뭐라 불러 	은행 업무 맡는 사람 호칭	2
어젯밤 이메일 중 첨부 파일 든 이메일이 있는가	어젯밤 이메일 중 첨부 파일 든 이메일 수	2
달에도 가는데 에이즈 치료제는 왜 아직 개발이 안될까 	에이즈 치료제 개발 안된 이유	2
서부산 요금소 정체가 되고 있나	서부산 요금소 정체 여부	0
출장은 지방이야 	출장 지방인지	0
술 마시고 있어	술 마시고 있는지	0
고구마 살까 으깬 감자로 할까 	고구마 으깬감자 중 살것	1
도서자료 열람실에서 공부 못해	도서자료 열람실 공부 가능한지	0
그래도 자유형이 제일 어려워	자유형이 제일 어려운지	0
브이자 반등을 기대해도 될까 	브이자 반등 기대해도 될지	0
신촌 부근 웨딩홀은 어디야	신촌 부근 웨딩홀 위치	2
생일이라며 아무것도 없어	아무것도 없는지	0
하루에 몇 시간 공부해야 원하는 대학에 갈까요 	원하는 대학 가기 위한 공부 시간	2
어젯밤 보낸 이메일 중 송신 확인이 안 된 이메일 얼마나 될까	어젯밤 보낸 이메일 중 송신 확인이 안 된 이메일 수	2
백야 현상이 무엇인지 알고 있어 	백야 현상 의미	2
부산역 주변 만두가 맛있는 중국집은 어떻게 간데	부산역 주변 만두가 맛있는 중국집 가는 방법	2
교수님이 해오라던 사설신문 스크랩 다했어 	사설신문 스크랩 다했는지	0
해외펀드는 환율에도 민감해	해외펀드 환율 민감 여부	0
이번 수업은 그냥 전시회로 대신 한다고 공고났어	이번 수업 전시회로 대신 하는지	0
내일 북경의 날씨는 어떻니	내일 북경 날씨	2
자장면이랑 햄버거 중 뭐 좋아해	자장면 햄버거 중 좋아하는 것	1
스쿠버가 스쿠터랑 어떤 관계가 있지 	스쿠버 스쿠터 관계	2
동의대 주변 플레이스테이션 방 어디더라	동의대 주변 플레이스테이션 방 위치	2
첨부 화일이 들어 있는 메일은 몇 개니	첨부 파일 들어 있는 메일 수	2
우리 교양수업 오늘 휴강된 거 확실해	교양수업 오늘 휴강 확실한지	0
서면 밀리오레 앞 도로 상황은 어떻지	서면 밀리오레 앞 도로 상황	2
집에 가고 있어	집에 가고 있는지	0
지금 저녁 먹고 있어	지금 저녁 먹고 있는지	0
중간에 경유하는 곳은 몇 군데	중간 경유하는 곳 수	2
회의와 관련된 주제만 다뤄	회의 관련 주제만 다루는지	0
서울까지 요금 얼마냐	서울까지 요금	2
이 번호로도 있나요	이 번호로도 있는지	0
강릉에 있는 해수욕장의 온도는 얼마나 되지	강릉 해수욕장 온도	2
지금 회의중	지금 회의중인지	0
휘발유가 리터당 얼마지	휘발유 리터당 가격	2
신호가 바뀌었는데 왜 출발을 안 하지 	출발 안 하는 이유	2
오월 이십일부터 출장이야	오월 이십일부터 출장인지	0
다시 뵙고 싶은데 다음 주에 시간 있으세요	다음 주 시간 있는지	0
갈 수 있지	갈 수 있는지	0
열대야가 얼마나 오래 갈까	열대야 지속 기간	2
어린이대공원 정문 차량 흐름은 어때	어린이대공원 정문 차량 흐름	2
무선 인터넷과 관련된 기사는 뭔데	무선 인터넷 관련 기사	2
요즘 잘나가는 모델의 차가 뭐 있지	요즘 잘나가는 모델의 차	2
그 은행에 대해서 자세히 알고 있어	그 은행 자세히 알고 있는지	0
잠실에서 냉면이 맛있는 집이 어떻게 가는가	잠실 냉면 맛있는 집 가는 방법	2
오늘 밤에 저와 저녁 괜찮으세요	오늘 저녁 가능 여부	0
약속하셨나요	약속 여부	0
왜 아무도 안 오는 거야	아무도 안 오는 이유	2
룸 서비스로 아침 식사 해도 될까요	룸 서비스 아침 식사 가능 여부	0
액션영화 멜로영화 중 뭐 볼 거래 	액션영화 멜로영화 중 볼 것	1
해외유학을 갔다 왔다면서 거기 생활은 어땠니 	해외유학 생활	2
민정이는 오기로 했는데 오빠 친구들도 온대	오빠 친구들도 오는지	0
너 수영 꽤 오래했지 어때 살 좀 빠졌냐 	살 빠졌는지	0
어젯밤 이메일 중 첨부 파일 든 이메일이 있는가	어젯밤 이메일 중 첨부 파일 든 이메일이 있는지	0
파크 호텔이요	파크 호텔인지	0
혹시나 저축 은행이 망해도 원금을 보장 받을 수 있나요 	저축 은행 망해도 원금 보장 받을 수 있는지	0
전부 증권주로 바꿨어	전부 증권주로 바꿨는지	0
패러글라이딩은 좀 위험하지 않을까	패러글라이딩 위험 여부	0
신세계 백화점 근처 전통 음식점 어디냐	신세계 백화점 근처 전통 음식점	2
이번 학기 축제 공식 휴강일이 언제냐	이번 학기 축제 공식 휴강일	2
주말엔 가족과 함께 벌초 갔다 왔어 넌 주말에 뭐했어 	주말에 한 일	2
구정은 언제냐	구정 날짜	2
내일 사회대 학생회실에서 엿 나눠줌	내일 사회대 학생회실 엿 나눠주는지	0
회사를 다니면서 학위를 딸 수 있는 방법이 없을까 	회사를 다니면서 학위 딸 수 있는 방법	2
자기야 영화 볼까 그냥 잘까 	영화볼지 그냥 잘지	1
제목에 결제라고 들어간 이메일이 몇 개지	제목에 결제라고 들어간 이메일 수	2
강남역에서 우드스탁 가는 길에 편의점이 있니	강남역에서 우드스탁 가는 길에 편의점 있는지	0
춘천까지 기차랑 버스 얼마나 걸리는지 알아	춘천 기차 버스 소요시간	2
서울 종로 음식점은 어떻게 가니	서울 종로 음식점 가는 방법	2
지금 뭐 해	지금 하는 것	2
보낸 메일함에 전체 이메일 몇 통이냐	보낸 메일함 전체 이메일 수	2
크리스마스트리 장식할 때 하루 쉴 거야	크리스마스트리 장식할 때 하루 쉴지	0
우산은 있어	우산 있는지	0
수표 분실 신고는 했어 	수표 분실 신고 여부	0
주식을 하면 왜 흔히들 망하는 걸까	주식 하면 망하는 이유	2
조직행위관리 숙제 오월 삼십일까지 제출하는 것 맞나요	조직행위관리 숙제 기한	2
지금이 기회인 거 같은데 전부 사들일까 	전부 사들일지	0
용산 가려면 뭐 타고 가면 될까	용산 가는 방법	2
기말고사 시험범위 알어	기말고사 시험범위	2
나 약국 가는 데 뭐 필요한 거 없어 	약국 필요한 것	2
공개형 폐쇄형 주식회사의 차이점이 뭐야 	공개형 폐쇄형 주식회사 차이점	2
오늘 메일 중 첨부 파일이 든 메일은 얼마나 되는가	오늘 메일 중 첨부 파일이 든 메일 수	2
동서대 근처 내과 어떻게 가는가	동서대 근처 내과 가는 방법	2
뭐 타고 갈 거야 내가 데릴러 갈까 	내가 데릴러 갈지	0
얼마나 멀어요	거리	2
주식 투자는 운입니까 실력입니까	주식 투자 운인지 실력인지	1
무교동 주변 낙지 전문점 어떻게 가니	무교동 주변 낙지 전문점 가는 방법	2
제가 저번에 산 주식이 내려가고 있는데 후딱 팔아버릴까요	저번 산 주식 팔지	0
누가 책임을 지죠	책임지는 사람	2
따로 갈까 뒤따라 갈까	따로 갈지 뒤따라 갈지	1
해외 송금 어떻게 하는 거야	해외 송금 방법	2
자기 차가 더 편할까 아니면 대중교통이 더 편할까	자기 차 대중교통 중 편한 것	1
대중교통과 자가용 중 어떤 방법이 저렴하고 편할까요	대중교통 자가용 중 저렴하고 편한 것	1
주식 종류에 따라 투자 전략도 달라지는 거야	주식 종류 따라 투자 전략 달라지는지	0
체크 아웃은 몇 시에 한데	체크 아웃 시간	2
오전에 회사에서 전화 왔었어요	오전 회사 전화 왔었는지	0
우리가 예상 했던 문제가 아니야	예상 했던 문제 아닌지	0
진료가 내일 오전 아홉 시로 예약 돼 있죠	진료 내일 오전 아홉 시인지	0
부천역 근처 롯데리아는 어떻게 가니	부천역 근처 롯데리아 가는 방법	2
아령 몇 키로가 적당한 거니	적당한 아령 무게	2
지역별 전운량이 어때	지역별 전운량	2
오늘 경제면 주요 소식 뭔데	오늘 경제면 주요 소식	2
비과세 혜택이 있는 건 어떤 거지	비과세 혜택 의미	2
저녁때 볼만한 방송 있어	저녁때 볼만한 방송	2
마을버스 운행시간 아니	마을버스 운행시간	2
왜 오토바이는 할부금융이 없는 건지요	오토바이 할부금융 없는 이유	2
뒤에서 무릎 구부릴 때 찍은 사진 가지고 계세요	뒤에서 무릎 구부릴 때 찍은 사진 있는지	0
현금으로 계산하십니까 아니면 카드로 계산하십니까	현금 카드 중 계산할 것	1
목표 수익율이 몇이십니까	목표 수익율	2
오늘 서울 지역 구름 양은 얼마야	오늘 서울 지역 구름 양	2
메이저 골프대회 상금 순위 관련 기사는 없을까	메이저 골프대회 상금 순위 관련 기사	2
어떻하면 좋아	대책	2
스킨 스쿠버 하다가 상어를 만나면 어쩐대 	스킨스쿠버 상어 대책	2
스트레칭을 하면 몸이 유연해져	스트레칭 몸 유연해지는지	0
증권정보 사이트에 회원 가입하려고	증권정보 사이트 회원 가입할지	0
정말이지	정말인지	0
체육복 깜박하고 안 가져왔어	체육복 안 가져왔는지	0
취약과목은 어떻게 공부해야할지 모르겠어	취약과목 공부 방법	2
이번 출장은 해외입니까	이번 출장 해외 여부	0
태풍 온데	태풍 오는지	0
춘천까지 기차랑 버스 얼마나 걸리는지 알아	춘천 기차 버스 소요시간	2
전자지도 서비스를 이용할 수 있나	전자지도 서비스 이용 가능 여부	0
경부 고속도로 지체구간은 어디지	경부 고속도로 지체구간	2
어젯밤 온 메일 중 첨부 파일이 든 메일은 몇 통이나 된데	어젯밤 온 메일 중 첨부 파일이 든 메일 수	2
끝났어	끝났는지	0
요즘 유기농 다이어트가 유행이야	요즘 유기농 다이어트 유행인지	0
파워 포인트 써서 발표한 조도 있었어	파워 포인트 써서 발표한 조도 있는지	0
그런데 계좌번호는 왜 알려준 거야	계좌번호 알려준 이유	2
걔는 야외 결혼식을 했어	걔 야외 결혼식 했는지	0
언닌 재테크 어떻게 하고 있어 	재테크 방법	2
이번에 우리학교에서 수능시험 만점자 나왔어	이번 우리학교 수능시험 만점자 나왔는지	0
택시 기본요금 또 오른데	택시 기본요금 상승 여부	0
주택 상속 세율 알고 있어	주택 상속 세율	2
내일 비가 오면 야외학습이 취소래	내일 비 오면 야외학습 취소인지	0
너의 학부는 어떻게 되니	학부	2
담양에 내려가는 건 이번이 처음이야	담양 처음 내려가는지	0
과장님 야근하셨는데 몸은 좀 어떠세요	몸 상태	2
그 원단으로 결정했어	그 원단으로 결정했는지	0
명동에서 연인들이 가장 많이 찾는 라면집은 어디지	명동 연인들이 가장 많이 찾는 라면집	2
프랑스의 화폐가 뭐니	프랑스 화폐	2
한달 삼백만원 정도의 금액을 어떻게 저축하면 좋을까요	한달 삼백만원 금액 저축 방법	2
오늘 새 편지가 몇 통 왔는가	오늘 온 새 편지 수	2
눈 내릴 때 우산을 써야할까 아니면 그냥 맞아야 할까	눈 내릴 때 우산 쓸지 그냥 맞을지	1
행당동 근처 중국요리집은 어딘데	행당동 근처 중국요리집 위치	2
그 외에 금융회사를 예를 든다면 어떤 것이 있을까요 	그 외 금융회사	2
세미나는 잘 다녀오셨어요	세미나 잘 다녀왔는지	0
카드로 샀어	카드로 샀는지	0
대대장입니다 강우식어머님 별고없으십니까	잘 지내는지	0
열차표 다섯 장 예매했어	열차표 다섯 장 예매했는지	0
보건소에서도 예방접종 한대	보건소 예방접종 여부	0
오늘 동아리 모임 끝나고 뒤풀이 있을 텐데 거기 올래 	뒤풀이 참석 여부	0
주차 중 이야	주차 중인지	0
담당교수님의 성함이 뭐지	담당교수님 성함	2
입금표 계좌번호를 입력하면 자동으로 이름이 떠	입금표 계좌번호 입력하면 자동으로 이름 뜨는지	0
좀 더 기다릴까 아니면 그냥 갈까	좀 더 기다릴지 그냥 갈지	1
지금 쫌 빨리 가는 방법이 없을까	빨리 가는 방법	2
너 배 타고 외국 가 본 적 있어	배 타고 외국 가 본 적 있는지	0
여기는 처음이신가요	여기가 처음인지	0
부산 시내 정체구간 어딜까	부산 시내 정체구간	2
논문 발표일이 언제야	논문 발표일	2
이러다 비가 눈으로 바뀌는 것 아닐까	비가 눈으로 바뀌는 것 아닐지	0
창원터널 진입로는 상황이 어때	창원터널 진입로 상황	2
청담대교 부근에 돌발 상황이 있니	청담대교 부근 돌발 상황 여부	0
호법 분기점 많이 막히지	호법 분기점 많이 막히는지	2
얼마나 구울까요	구울 정도	2
스키와 스노보드 중 어떤 것이 더 쉬운가요	스키 스노보드 중 쉬운 것	1
심리학 개론 시험 범위가 어디서부터 어디까지야 	심리학 개론 시험 범위	2
여기는 처음이신가요	여기 처음인지	0
내일 클럽활동 뭐하니	내일 클럽활동	2
오늘 밤에 도착 메일 몇 통이래	오늘 밤 도착 메일 수	2
영어 회화 어떻게 공부했어 	영어 회화 공부 방법	2
장외주식하고 장내주식하고 차이가 뭐지 	장외주식 장내주식 차이	2
강남역 근처 일마레 어디냐	강남역 근처 일마레 위치	2
동아쇼핑 근처에 병원들 많아	동아쇼핑 근처 병원들 많은지	0
그 헬스클럽은 수영을 위주로 한대	그 헬스클럽 수영 위주인지	0
갈수록 너무 예뻐지는 것 같더라 비결이 뭐니	갈수록 예뻐지는 비결	2
오늘은 누구 왔니	오늘 온 사람	2
어제 날씨가 춥던데 몸은 괜찮니	몸 괜찮은지	0
듣기 싫어	듣기 싫은지	0
계좌 이체하는 데 수수료가 얼마인지 아니 	계좌 이체 수수료	2
여기 집 위치를 잘 모르겠어	집 위치	2
필리핀과 태국중에 어디 상품이 더 싸니	필리핀 태국 중 상품 싼 곳	1
현관에 온 사람이 있니	현관 사람 여부	0
광주에 사회복지회관이 어디야	광주 사회복지회관 위치	2
몇 퍼센트를 가지고 있어야 주주 총회에 갈 수 있나요	주주 총회 가능 퍼센트	2
내일 최저 기온은 몇 도야	내일 최저 기온	2
첨부 파일이 든 메일이 없지	첨부 파일 든 메일이 있는지	0
주택 청약 어디 거가 좋을까	주택 청약 좋은 곳	2
신림동 근처 문구점은 어떻게 간데	신림동 근처 문구점 가는 방법	2
요즘 포토샵 처리하는 기능 쉬워	포토샵 처리 기능 쉬운지	0
하체 강화운동에는 무엇이 있을까 	하체 강화운동 종류	2
베란다 꽃에 물을 줬나	베란다 꽃 물 줬는지	0
토요일에 볼까 일요일에 볼까	토요일에 볼지 일요일에 볼지	1
삼월 오일에 집에 내려가	삼월 오일 집 내려가는지	0
내년 구정연휴가 며칠이나 된데	내년 구정연휴 기간	2
요새 전자 쪽에 투자하는 게 좋을까	요새 전자 쪽 투자 좋을지	0
스톡옵션이 뭔 줄 아니	스톡옵션 의미	2
이번 주 일요일이 곗날 맞지	이번 주 일요일 곗날 여부	2
언제쯤 저녁 시간이 편하신가요	저녁 시간 편한 날짜	2
현재 경부 고속도로의 소통은 원활하니	현재 경부 고속도로 소통 원활 여부	0
문화원 수업 프로그램이 좋아	문화원 수업 프로그램 좋은지	0
공부는 잘 돼가니	공부 잘 돼가는지	0
수술 휴유중으로 입원하셨던 거 잘 치료 되셨나요 	수술 후유증 치료 여부	0
걔가 교통사고 후유증 때문에 차 타는 걸 무서워해 	걔 교통사고 후유증으로 차 무서워하는지 	0
왜 아직까지도 돈을 안 붙여줄까	아직까지도 돈을 안 붙이는 이유	2
기차 좌석은 어디서 예약하나요	기차 좌석 예약하는 곳	2
병원 갔다 왔어	병원 갔다 왔는지	0
이번 동계올림픽은 어느 나라에서 하지 	이번 동계올림픽 하는 곳	2
일본 날씨가 어떻지	일본 날씨	2
홈쇼핑으로 전기밥솥 샀어	홈쇼핑으로 전기밥솥 샀는지	0
재경부 차관 면담 계획은 잡혔나	재경부 차관 면담 계획 잡혔는지	0
할부로 샀어	할부로 샀는지	0
영국까지 화물 수송비가 정확히 얼마인가요	영국까지 화물 수송비	2
내일 비온대	내일 비오는지	0
그냥 학교 보건소 갈래	그냥 학교 보건소 갈지	0
종이 통장 없이 직불카드만 만들 수도 있어	종이 통장 없이 직불카드만 만들 수도 있는지	0
지금 예술의 전당 앞 지나는 중이야	지금 예술의 전당 앞 지나는지	0
윗몸 일으키기 복근에 정말 좋아	윗몸 일으키기 복근에 좋은지	0
주임님 커피 한 잔 하실래요	커피 한잔 할지	0
올해 신년 연하장 많이 보냈어	올해 신년 연하장 많이 보냈는지	0
인사관리 수업 폐강이래	인사관리 수업 폐강 여부	0
오늘 울릉도 해상 날씨는 어때	오늘 울릉도 해상 날씨	2
기분 좋아	기분 좋은지	0
집들이는 다섯 시니까 한 네 시쯤에 만날까	네 시 쯤 만날지	0
어학연수 계획하는 거야	어학연수 계획하는지	0
현관에 온 사람 있어	현관에 온 사람 있는지	0
이번 주 일요일에 일정 있을까	일요일 일정 여부	0
투자자들의 반응은 어떤거 같아	투자자 반응	2
순방향 좌석은 할인이 되니	순방향 좌석 할인 가능 여부	0
오늘 미적분 시험 어려웠어	오늘 미적분 시험 어려웠는지	0
오늘 계약 한 건 했다 뭐 먹고 싶어 	먹고 싶은 것	2
올 여름 예상 강수량이 어때	올 여름 예상 강수량	2
쓰레기 재활용일이 언제인가	쓰레기 재활용일	2
짐 제한 무게가 얼마니	짐 제한 무게	2
지역별 날씨 전망은 어떠니	지역별 날씨 전망	2
내 방에서 일본까지 전화 직접 걸 수 있나요	일본 직접 전화 가능 여부	0
너 혹시 교육학 인터넷 강의 들어본 적 있어	교육학 인터넷 강의 들어본 적 있는지	0
인문계열 과목이 더 쉬워	인문계열 과목 더 쉬운지	0
저녁때 볼만한 방송 있어	저녁때 볼만한 방송	2
부산대학병원에서 제일 가까운 약국은 어디지	부산대학병원에서 제일 가까운 약국	2
함안에 의령까지 국도가 어때	함안 의령까지 국도 상황	2
민호 오월 달에 결혼한데	민호 오월 달 결혼 여부	0
오늘 승훈씨와 만나기로 한 시간이 언제지	오늘 승훈씨와 만나기로 한 시간	2
왜 아까 못들은 척 한거야	아까 못들은 척 한 이유	2
오늘 체육 수업은 교실에서 하신 데	오늘 체육 수업 교실에서 하는지	0
어 약속을 깜빡 했어 어떻게 하지 	약속 깜빡한 상황 대책	2
책을 살까 아니면 제본으로 할까	책 살지 제본으로 할지	1
유명한 찜닭 전문점이 강동구에서 어디에 있지	강동구 유명한 찜닭 전문점 위치	2
뭐만 먹으면 자꾸 토하는데 어떡하니	먹으면 토하는 상황 대책	2
남산공원 부근 편의점 어떻게 가	남산공원 부근 편의점 가는 방법	2
통증완화제 같은 거 놔줬어	통증완화제 같은 거 놔줬는지	0
어젯밤 온 새 메일은 몇 통인가	어젯밤 온 새 메일 수	2
오늘 보는 사람마다 너 괜찮느냐고 묻더라	괜찮은지	0
로맨틱 코메디 영화 보고 싶어	로맨틱 코메디 영화 보고 싶은지	0
조성민 선수의 현황은	조성민 선수 현황	2
왜 연락해도 통화가 안 되니 	통화 안 되는 이유	2
내일 카드 다 정지 시킬 거야	내일 카드 다 정지 시키는지	0
앨범 발표일이 언제지	앨범 발표일	2
티비 채언니는 유학 갔다가 언제 와	채언니 유학갔다가 오는 시기	2
내일 서리가 발생할까	내일 서리 발생 여부	0
보낸 편지함에 전체 메일 몇 통이지	보낸 편지함 전체 메일 수	2
부산대에서 해운대로 가는 길에 현재 공사구간이 있나	부산대에서 해운대로 가는 길 공사구간 여부	0
내일 바람 많이 부니	내일 바람 많이 부는지	0
요즘 학교는 잘 다니고 있지 	요즘 학교 잘 다니는지	0
이번 반상회는 어디서 하니	이번 반상회 위치	2
팔팔 도로 출근길 소통이 원할한 구역이 어디니	팔팔 도로 출근길 소통 원활한 구역	2
그 종목의 숨겨진 리스크가 있지 않을까	그 종목 숨겨진 리스크 여부	0
스키장 가는 중	스키장 가는 중인지	0
중간고사 잘 봤어	중간고사 잘 봤는지	0
저는 방학인데도 학교 나가고 있어요 언니도 잘 지내죠 	잘 지내는지	0
요금조정을 요청했는데 왜 처리가 안되지 	요금조정 처리 안되는 이유	2
지금 예약 했어	지금 예약 했는지	0
요금 채권이나 채무 쪽 일의 전망은 어때 	요즘 채권 채무 쪽 일 전망	2
내일 해수욕장 가는데 일기예보 들어봤니 	내일 일기예보 들어봤는지	0
컴퓨터는 함부로 강제 종료 하면 안돼	컴퓨터 함부로 강제 종료 하면 안되는지	0
어떻게 공부한 거야 너도 공부가 제일 쉬웠어요 이거야 	공부 방법	2
이번 쪽지 시험은 쉬웠어	이번 쪽지 시험 쉬웠는지	0
시골 갈 때 기차 탈까 아님 고속버스 탈까	시골 갈 때 기차 고속버스 중 탈 것	1
설계 참고 문서 정리 언제까지 하면 되죠	설계 참고 문서 정리 기한	2
나 새 차 살건 데 뭐가 좋을까	사기 좋은 차	2
이번에 제일은행 합병되면 은행에 있는 내 돈 위험해지는 거 아니지	제일은행 합병되면 돈 위험한지	0
스쿼시 배울 만한 곳이 어디 있나요	스쿼시 배울 만한 곳	2
뒤쪽으로 자리를 좀 옮겨도 될까요	뒤쪽으로 자리 옮겨도 될지	0
난 요새 늘 놀기만 하는데 넌 뭐하니	요새 하는 것	2
증권거래소의 위치는 어디입니까	증권거래소 위치	2
남들 다 파는데 당신만 끼고 있겠다는 이유가 대체 뭐야	남들 다 파는데 끼고 있겠다는 이유	2
언제 시간 여유가 생기시나요	시간 여유 생기는 시기	2
농협 직불카드 만들었어	농협 직불카드 만들었는지	0
카드 값 얼마야	카드 값 막는 방법	2
나의 발표는 언제야	나의 발표 시각	2
내일도 모레도 계속 비 온대	내일 모레 계속 비 오는지	0
헬스장 트레이너들은 왜 다들 느끼하게 생겼을까 	헬스장 트레이너 느끼하게 생긴 이유	2
문순이가 메일엔 답장을 보냈니	문순이 메일 답장 여부	0
오늘 점심 약속 아직 유효한 거지 	오늘 점심 약속 유효 여부	0
계좌이체랑 무통장 입금이랑 같은가	계좌이체 무통장 입금 차이	2
장외 주식이 상장되면 장내 주식으로 되나요 	장외 주식 상장 장내 주식 되는지	0
올리브유 마사지랑 현미식이 최고라는데 해봤어	올리브유 마사지 현미식 경험 여부	0
회의를 재미있게 하는 방법이 없을까 	회의 재미있게 하는 방법	2
담당 교수님 이름이 어떻게 되지	담당 교수님 이름	2
부산에서 제일 안 아프게 치료하는 치과는 어떻게 간데	부산에서 제일 안 아프게 치료하는 치과 가는 방법	2
스승의 날 선생님 선물 사야 돼	스승의 날 선생님 선물 사야 되는지	0
경마와 주식 중 어느 게 좋니	경마 주식 중 좋은 것	1
언제 먹을 거야	먹을 때	2
취미로 역도 같은 것도 하는 사람이 있을까	취미 역도 하는 사람 있을지	0
다리 아파	다리 아픈지	0
조카 교육보험 하나 든다는데 뭐 좋은 상품 없을까	조카 교육보험 좋은 상품	2
연신내 근처 한식 전문점은 어디지	연신내 근처 한식 전문점	2
댁의 아들은 학교에 잘 다니나요 	아들 학교 잘 다니는지	0
직불카드랑 체크카드는 뭐가 달라요	직불카드 체크카드 차이점	2
수신 확인이 된 새 메일 몇 통인가	수신 확인 된 새 메일 수	2
투자자가 나왔어요 	투자자가 나왔는지	0
남산터널에서는 왜 통행료를 내야 하는 거야	남산터널 통행료 내야 하는 이유	2
부산대 주변 나이트클럽은 어디래	부산대 주변 나이트클럽	2
비행기 타면 더 빨리 올 수 있어	비행기 타면 더 빨리 올 수 있는지	0
선배 오늘 모임에 갈 거예요	오늘 모임 갈지	0
중부지방에 오늘 비오니	중부지방 오늘 비오는지	0
남산공원 근처 편의점은	남산공원 근처 편의점	2
주윤이가 회신 보냈나	주윤이 회신 여부	0
필라테스랑 요가랑 뭐가 다른 거야	필라테스 요가 차이점	2
대출중개회사는 별도의 중개수수료를 요구 해	대출중개회사 별도 중개수수료 요구 여부	0
이렇게 어색할 수가 어떻게 해야 친해지는 거야	친해지는 방법	2
휴가 계획이 무산되었어 어떡해	휴가 계획 무산 대책	2
지금 어디야 난 수영장 왔어	지금 위치	2
고속도로와 국도 중 어느 것이 좋아	고속도로 국도 중 좋은 곳	1
영화 정말 볼 것 없어	영화 정말 볼 것 없는지	0
지금 어딨어	지금 위치	2
네가 말하는 그 업체가 청계천 복원 사업에 참여 한 거지 	그 업체 청계천 복원 사업 참여 여부	0
방카슈랑스란 무엇입니까 	방카슈랑스 의미	2
이 열차는 몇 번 플랫폼에서 출발해요	열차 출발 플랫폼	2
카드 없앤 건 좋은데 급할 땐 어디서 돈을 빌리지	급할 때 돈 빌릴 곳	2
베컴 관련 기사 찾아	베컴 관련 기사 찾는지	0
우리 학교에는 등산 동아리 없니	학교 등산 동아리 있는지	0
효과적으로 업무를 수행할 방법이 없을까 	효과적 업무 수행 방법	2
오래된 계좌도 쓸 수 있을까 	오래된 계좌 쓸 수 있을지	0
여가시간에 즐길 만한 스포츠 없을까 	여가시간 스포츠	2
갑자기 전철이 멈췄어	갑자기 전철 멈췄는지	0
괜찮읍니까	괜찮은지	0
여자친구 생일이 언제니	여자친구 생일	2
너 다이어트 하더니 살 좀 빠졌니	살 좀 빠졌는지	0
실장님이 뭐라고 안 해	실장님 뭐라고 안 하는지	0
경부 고속도로 내 소통 원활한 구간은 어딘가	경부고속도로 내 소통 원활 구간	2
네 전화 통화중대기 돼	통화중대기 가능 여부	0
혼합형 주식 펀드가 나을까 은행 적금이 나을까	혼합형 주식펀드 은행적금 중 나은 것	1
아까 전화 왔다는 문자 받으셨죠 	전화 왔다는 문자 받았는지	0
청담대교 부근에 돌발 상황이 있니	청담대교 부근 돌발 상황 여부	0
현재 중부 상행선 교통 통제 구간은 어떤데	현재 중부 상행선 교통 통제 구간 상황	2
간단한 샤워는 괜찮아	간단한 샤워 괜찮은지	0
만나서 좋았어	만나서 좋았는지	0
어제 보낸 메일 중 수신 확인 안 된 메일 얼마나 되는가	어제 보낸 메일 중 수신 확인 안 된 메일 수	2
오늘 털코트입으면 조금 오바인가	털코트 입기 적절할지	0
이십일 부산에 비가 올 확률은	이십일 부산 비 올 확률	2
누나의 개학은 언제야	누나 개학일	2
아이티 계열이 왜 주식이 올라	아이티 계열 주식 오르는 이유	2
학원 다니는 거 별 효과 없어	학원 효과 있는지	0
조기유학이 과연 효과가 있을까 	조기유학 효과 여부	0
서면 밀리오레 근처 유명한 닭 집은 어떻게 가니	서면 밀리오레 근처 닭집 가는 방법	2
비오는 날은 소방서 쉬니	비오는 날 소방서 쉬는지	0
오늘 수도권 아파트 시세는	오늘 수도권 아파트 시세	2
생활 쓰레기 수거일은	생활 쓰레기 수거일	2
요즘 어떻게 지내세요	근황	2
비자 신청해	비자 신청하는지	0
라켓볼이랑 스쿼시랑 서로 다른 거야	라켓볼 스쿼시 서로 다른지	0
병원 예약하려면 어떻게 해요	병원 예약 방법	2
어머니와 등산 가기로 약속한 날은	어머니 등산 약속 날	2
아까 주차위반 딱지 뗐어	아까 주차위반 딱지 뗐는지	0
감기약은 원래 식후 삼십 분에 복용 아니야 	감기약 복용 시간	2
정말 아프니	아픈지	0
등산 양말은 몇 켤레 필요해	필요 등산 양말 켤레 수	2
저번 주 일요일에 습도가 얼마나 됐지	저번 주 일요일 습도	2
올해 경제성장률 관련기사 뭘까	올해 경제성장률 관련기사	2
성함을 여쭤봐도 좋을까요	성함	2
어제 롯데 선수들의 게임 기사는 없을까	어제 롯데 선수들 게임 기사	2
버스 운전사랑 시비가 붙었어	버스 운전사랑 시비 붙었는지	0
핸드폰 바꿀까	핸드폰 바꿀지	0
내일 아침 최저 기온은 몇 도지	내일 아침 최저 기온	2
왜 걔한테 불똥이 튀었어	걔 불똥 튄 이유	2
목욕탕은 함부로 가면 안 되는 거야	목욕탕 함부로 가면 안 되는지	0
다른 주식들이 대거 상승한다고 뒤따라 가면 안되는 거야	다른 주식 상승 뒤따라 가면 안되는지	0
시골집에 갔다 오려 그러는 데 뭐 타고 갈 거니 	시골집 타고 갈 것	2
어떤 종류의 카메라를 샀는데요	산 카메라 종류	2
건강보험의 일년 금액은 얼마에요	건강보험 일년 금액	2
삼성 같은 대기업과 연결이 될까	대기업 연결 가능 여부	0
부산에서 분위기 제일 좋은 호텔 바는 어디일까	부산 분위기 좋은 호텔 바	2
파워포인트 시험은 통과했어	파워포인트 시험 통과 여부	0
누나가 롯데백화점에서 만나자고 했어	누나가 롯데백화점에서 만나자고 했는지	0
기공체조가 뭐야 태극권처럼 그런 거야 	기공체조 의미	2
어떻게 된 거야	상황	2
오늘 전남지역 구름 양은 어때	오늘 전남지역 구름 양	2
내일 오전에 계실 거죠 열한 시 정도에 방문하겠습니다	내일 오전에 있는지	0
근데 도서관에 왜 만화책 없니	도서관 만화책 없는 이유	2
짐 제한 무게는 얼마니	짐 제한 무게	2
아웃백 싸게 먹을려면 뭐 먹어야해	아웃백 싸게 먹을 수 있는 메뉴	2
천호대교 교통상황은 어떠냐	천호대교 교통상황	2
토익시험 일자가 며칠이니	토익시험 일자	2
그 은행 직원들이 예쁘고 친절해	그 은행 직원들 예쁘고 친절한지	0
정기 적금 해약하면 손해가 클까	정기 적금 해약 손해 클지	0
샌드위치 싸서 산책 나가	샌드위치 싸서 산책 나가는지	0
지난달에 미용실에 간 날은 언제지	지난달 미용실 간 날	2
재수없고 못생긴 휴잇이 로딕을 이겼어	휴잇이 로딕 이겼는지	0
어젯밤 새 메일 중 정자 아이디로 된 이메일 있지	어젯밤 새 메일 중 정자 아이디로 된 이메일 여부	0
아테네 올림픽 한국 양궁팀의 순위 관련 기사는	아테네 올림픽 한국 양궁팀 순위 관련 기사	2
주식 딜러가 되고 싶은데 어떻게 하지 	주식 딜러 되는 방법	2
적금을 얼마짜리를 들길래 그렇게 많이 넣어	적금 규모	2
내일이 학부모 회의 날이라고 엄마께 알려드렸니 	내일 학부모 회의 엄마께 알려드렸는지	0
동창모임이 이번 주에 있니	동창모임 이번 주에 있는지	0
소득공제 혜택을 받을 수 있습니까	소득공제 혜택 받을 수 있는지	0
아홉시 출발 몇 시 도착이냐	도착 시각	2
아테네 올림픽 마스코트 관련 기사는 없을까	아테네 올림픽 마스코트 관련 기사	2
아이들은 잘 크고 있겠지 	아이들 잘 크고 있는지	0
광주 비엔날레하는 근처에 민박집이 있나	광주 비엔날레 근처 민박집 여부	0
그거 쉽게 풀리는 거야	그거 쉽게 풀리는지	0
새해 첫 개장날 배당락이 이뤄지는 게 맞지	새해 첫 개장날 배당락 이뤄지는지	0
왜 약속시간에 늦지 말아야 하는가 	약속시간 늦지 말아야 하는 이유	2
요가를 배워보려고 하는데 어떻게 생각하니 	요가 배우는 것에 대한 생각	2
우리 최고 몇 학점까지 들을 수 있지	최고 가능 학점 수	2
마츠이 히데키의 소속 구단 관련 기사는	마츠이 히데키 소속 구단 관련 기사 여부	0
오빠 요새 잘 지내고 있나요	요새 잘 지내는지	0
정기예금과 정기적금의 차이점이 뭐야	정기예금 정기적금 차이점	2
내일 설계 스튜디오 뒷풀이 있어요 	내일 설계 스튜디오 뒷풀이 여부	0
문자 안해	문자 안하는지	0
앓아 누웠어	앓아 누웠는지	0
너 주위에 주식에 대해 잘 아는 사람 없어 	주식 전문가 아는지	0